證券名稱,簡稱,年月日,投信買賣超(千股),投信買賣超市值(百萬),投信持股數(千股),投信持股數市值(百萬),合計買賣超(千股),合計買賣超市值(百萬),合計持股數(千股),合計持股數市值(百萬),外資買進張數,外資賣出張數,投信持股率%,投信買進張數,投信賣出張數,投信週轉率%
1301,台塑         ,20130102,0,0,69828,5516.41,2520,199.08,2235392,176595.97,2830,685,1.14,0,0,0
1301,台塑         ,20130103,329,26.25,70157,5598.53,2977,237.56,2238369,178621.85,3537,920,1.15,337,8,0
1301,台塑         ,20130104,231,18.55,70388,5652.16,5133,412.18,2243532,180155.62,6083,1360,1.15,344,113,0
1301,台塑         ,20130107,271,21.68,70659,5652.72,903,72.24,2244465,179557.2,3179,2732,1.15,360,89,0
1301,台塑         ,20130108,813,65.12,71472,5724.91,1395,111.74,2244930,179818.89,2021,1191,1.17,859,46,0.01
1301,台塑         ,20130109,-72,-5.76,71400,5712,990,79.2,2245930,179674.4,2140,1050,1.17,0,72,0
1301,台塑         ,20130110,21,1.72,71421,5849.38,5474,448.32,2251469,184395.31,9851,4753,1.17,171,150,0
1301,台塑         ,20130111,602,48.76,72023,5833.86,586,47.47,2252065,182417.27,1750,1347,1.18,705,103,0.01
1301,台塑         ,20130114,-146,-11.65,71877,5735.78,-1215,-96.96,2250852,179617.99,2079,2929,1.17,215,361,0
1301,台塑         ,20130115,-5,-0.4,71872,5764.13,1254,100.57,2252146,180622.11,3617,2172,1.17,0,5,0
1301,台塑         ,20130116,167,13.24,72039,5712.69,-209,-16.57,2252057,178588.12,2824,3662,1.18,190,23,0
1301,台塑         ,20130117,-158,-12.45,71881,5664.22,641,50.51,2252438,177492.11,2587,1729,1.17,0,158,0
1301,台塑         ,20130118,-1,-0.08,71880,5764.78,1668,133.77,2254070,180776.41,2951,1272,1.17,0,1,0
1301,台塑         ,20130121,-66,-5.27,71814,5737.94,16,1.28,2254323,180120.41,1489,1375,1.17,0,66,0
1301,台塑         ,20130122,-129,-10.32,71685,5734.8,677,54.16,2254924,180393.92,1816,911,1.17,0,129,0
1301,台塑         ,20130123,-113,-9.02,71572,5711.45,640,51.07,2255574,179994.81,1657,900,1.17,0,113,0
1301,台塑         ,20130124,-88,-6.93,71484,5632.94,-774,-60.99,2254846,177681.86,1893,2375,1.17,4,92,0
1301,台塑         ,20130125,-738,-58.15,70746,5574.78,-590,-46.49,2254277,177637.03,4746,4208,1.16,0,738,0.01
1301,台塑         ,20130128,-112,-8.79,70634,5544.77,888,69.71,2255177,177031.39,1639,630,1.15,0,112,0
1301,台塑         ,20130129,-298,-23.54,70336,5556.54,243,19.2,2255296,178168.38,2433,1857,1.15,0,298,0
1301,台塑         ,20130130,-150,-12,70186,5614.88,1820,145.6,2257028,180562.24,4172,2011,1.15,0,150,0
1301,台塑         ,20130131,11,0.88,70197,5629.8,1829,146.69,2258233,181110.29,5265,3323,1.15,18,7,0
1301,台塑         ,20130201,-649,-51.98,69548,5570.79,790,63.28,2258913,180938.93,3073,1617,1.14,0,649,0.01
1301,台塑         ,20130204,-168,-13.61,69380,5619.78,1090,88.29,2260151,183072.23,3125,1885,1.13,181,349,0
1301,台塑         ,20130205,-300,-24.27,69080,5588.57,1235,99.91,2261501,182955.43,3702,2031,1.13,0,300,0
1301,台塑         ,20130206,-49,-3.92,69031,5522.48,-773,-61.84,2261134,180890.72,4370,4539,1.13,0,49,0
1301,台塑         ,20130218,-337,-26.62,68694,5426.83,-240,-18.96,2261536,178661.34,7755,7026,1.12,0,337,0
1301,台塑         ,20130219,-1418,-111.88,67276,5308.08,-1987,-156.77,2259544,178278.02,1522,1877,1.1,0,1418,0.01
1301,台塑         ,20130220,-415,-32.62,66861,5255.27,-1844,-144.94,2258150,177490.59,7103,8242,1.09,0,415,0
1301,台塑         ,20130221,-140,-10.95,66721,5217.58,-1873,-146.47,2256551,176462.29,4354,5793,1.09,0,140,0
1301,台塑         ,20130222,-68,-5.28,66653,5172.27,-3133,-243.12,2253453,174867.95,1693,4698,1.09,0,68,0
1301,台塑         ,20130223,-8,-0.62,66645,5204.97,-97,-7.58,2253484,175997.1,41,2,1.09,0,8,0
1301,台塑         ,20130225,-580,-44.83,66065,5106.82,-2329,-180.03,2251307,174026.03,2446,3970,1.08,0,580,0
1301,台塑         ,20130226,-126,-9.64,65939,5044.33,-4218,-322.68,2247014,171896.57,4999,8965,1.08,0,126,0
1301,台塑         ,20130227,-363,-27.23,65576,4918.2,-5812,-435.9,2241615,168121.13,3288,8804,1.07,0,363,0
1301,台塑         ,20130301,-391,-30.03,65185,5006.21,-5,-0.38,2241656,172159.18,4756,4324,1.06,49,440,0
1301,台塑         ,20130304,-449,-33.5,64736,4829.31,-7307,-545.1,2234303,166679,2650,10141,1.06,0,449,0
1301,台塑         ,20130305,-1186,-88.12,63550,4721.77,-3354,-249.2,2230949,165759.51,1941,4415,1.04,0,1186,0.01
1301,台塑         ,20130306,-1006,-75.15,62544,4672.04,-1536,-114.74,2229783,166564.79,2603,4147,1.02,120,1126,0.01
1301,台塑         ,20130307,-55,-4.15,62489,4717.92,27,2.04,2228972,168287.39,849,1240,1.02,0,55,0
1301,台塑         ,20130308,-216,-16.33,62273,4707.84,-657,-49.67,2228569,168479.82,6483,6984,1.02,0,216,0
1301,台塑         ,20130311,-379,-28.65,61894,4679.19,-1572,-118.84,2227448,168395.07,4136,5262,1.01,0,379,0
1301,台塑         ,20130312,-54,-4.08,61840,4668.92,-479,-36.16,2226969,168136.16,1316,1709,1.01,0,54,0
1301,台塑         ,20130313,-170,-12.5,61670,4532.75,-7796,-573.01,2219173,163109.22,1235,7086,1.01,0,170,0
1301,台塑         ,20130314,-688,-49.67,60982,4402.9,-6375,-460.28,2212798,159764.02,1443,7027,1,0,688,0.01
1301,台塑         ,20130315,-5602,-417.35,55380,4125.81,-6514,-485.29,2206413,164377.77,16388,17400,0.9,114,5716,0.05
1301,台塑         ,20130318,-51,-3.71,55329,4022.42,-3573,-259.76,2202851,160147.27,704,4190,0.9,69,120,0
1301,台塑         ,20130319,-531,-38.5,54798,3972.86,-3198,-231.85,2199753,159482.09,1810,4491,0.9,0,531,0
1301,台塑         ,20130320,-157,-11.23,54641,3906.83,-5494,-392.82,2194171,156883.23,604,5668,0.89,0,157,0
1301,台塑         ,20130321,-162,-11.55,54479,3884.35,-3348,-238.71,2190542,156185.64,775,3978,0.89,0,162,0
1301,台塑         ,20130322,-308,-22.02,54171,3873.23,-1582,-113.11,2188960,156510.64,2649,3887,0.89,0,308,0
1301,台塑         ,20130325,0,0,54171,3894.89,-618,-44.43,2188361,157343.16,1254,1887,0.89,0,0,0
1301,台塑         ,20130326,-113,-7.99,54058,3821.9,-3021,-213.58,2185182,154492.37,1709,4593,0.88,0,113,0
1301,台塑         ,20130327,-337,-23.86,53721,3803.45,-852,-60.32,2184411,154656.3,1795,2401,0.88,0,337,0
1301,台塑         ,20130328,-90,-6.35,53631,3786.35,-2844,-200.79,2181566,154018.56,1887,4595,0.88,0,90,0
1301,台塑         ,20130329,2,0.14,47284,3399.72,1307,93.97,2176255,156472.73,1769,458,0.77,2,0,0
1301,台塑         ,20130401,-4,-0.28,47280,3366.34,-237,-16.87,2176018,154932.48,373,715,0.77,0,4,0
1301,台塑         ,20130402,16,1.14,47296,3381.66,-1533,-109.61,2174615,155484.97,2352,3922,0.77,35,19,0
1301,台塑         ,20130403,0,0,47296,3362.75,-1194,-84.89,2173193,154514.02,665,1886,0.77,0,0,0
1301,台塑         ,20130408,-90,-6.3,47206,3304.42,-3362,-235.34,2170242,151916.94,4181,7486,0.77,0,90,0
1301,台塑         ,20130409,-50,-3.5,47156,3296.2,-3139,-219.42,2167112,151481.13,1177,4156,0.77,0,50,0
1301,台塑         ,20130410,0,0,47156,3230.19,-6818,-467.03,2160534,147996.58,2548,9172,0.77,0,0,0
1301,台塑         ,20130411,-98,-6.86,47058,3294.06,-2001,-140.07,2158613,151102.91,1711,3584,0.77,0,98,0
1301,台塑         ,20130412,-1,-0.07,47057,3293.99,-1397,-97.79,2157515,151026.05,996,2249,0.77,0,1,0
1301,台塑         ,20130415,-49,-3.43,47008,3290.56,-803,-56.21,2156831,150978.17,1087,1792,0.77,0,49,0
1301,台塑         ,20130416,-109,-7.52,46899,3236.03,-3174,-219.01,2153895,148618.76,1205,4322,0.77,0,109,0
1301,台塑         ,20130417,-85,-5.78,46814,3183.35,-5676,-385.97,2148574,146103.03,2788,8075,0.76,0,85,0
1301,台塑         ,20130418,0,0,46814,3173.99,-3335,-226.11,2145167,145442.32,1084,4501,0.76,0,0,0
1301,台塑         ,20130419,-61,-4.17,46753,3197.91,-1502,-102.74,2142823,146569.09,1558,3070,0.76,19,80,0
1301,台塑         ,20130422,-7,-0.48,46746,3225.47,-402,-27.74,2142352,147822.29,1280,1773,0.76,0,7,0
1301,台塑         ,20130423,-16,-1.1,46730,3224.37,-790,-54.51,2140145,147670.01,1104,1845,0.76,0,16,0
1301,台塑         ,20130424,-20,-1.45,46710,3377.13,1473,106.5,2141286,154814.98,4223,3569,0.76,0,20,0
1301,台塑         ,20130425,386,27.87,47096,3400.33,1148,82.89,2142831,154712.4,5803,4517,0.77,400,14,0
1301,台塑         ,20130426,-9,-0.65,47087,3399.68,1106,79.85,2144164,154808.64,7214,6142,0.77,0,9,0
1301,台塑         ,20130429,-46,-3.27,47041,3339.91,-511,-36.28,2144298,152245.16,2270,2619,0.77,0,46,0
1301,台塑         ,20130430,0,0,47041,3368.14,-893,-63.94,2143554,153478.47,5083,5917,0.77,0,0,0
1301,台塑         ,20130502,-30,-2.15,47011,3375.39,-66,-4.74,2143618,153911.77,6360,6417,0.77,0,30,0
1301,台塑         ,20130503,62,4.39,47073,3332.77,-2363,-167.3,2141419,151612.47,1028,3368,0.77,112,50,0
1301,台塑         ,20130506,56,4.01,47129,3374.44,-637,-45.61,2140718,153275.41,2235,3095,0.77,75,19,0
1301,台塑         ,20130507,0,0,47129,3383.86,-276,-19.82,2140972,153721.79,2129,2414,0.77,0,0,0
1301,台塑         ,20130508,0,0,47129,3454.56,1867,136.85,2159988,158327.12,5119,3785,0.77,0,0,0
1301,台塑         ,20130509,-186,-13.67,46943,3450.31,1306,95.99,2161384,158861.72,5302,3262,0.77,0,186,0
1301,台塑         ,20130510,-96,-7.1,46847,3466.68,2694,199.36,2164078,160141.77,4474,1630,0.77,0,96,0
1301,台塑         ,20130513,-14,-1.02,46833,3418.81,-128,-9.34,2164050,157975.65,756,827,0.77,0,14,0
1301,台塑         ,20130514,44,3.22,46877,3426.71,1204,88.01,2165814,158321,3097,2188,0.77,45,1,0
1301,台塑         ,20130515,40,2.96,46917,3467.17,1284,94.89,2167273,160161.47,3495,1845,0.77,40,0,0
1301,台塑         ,20130516,210,15.67,47127,3515.67,-1260,-94,2166010,161584.35,2826,4399,0.77,210,0,0
1301,台塑         ,20130517,52,3.83,47179,3472.37,223,16.41,2166318,159441,1252,1031,0.77,73,21,0
1301,台塑         ,20130520,-46,-3.37,47133,3454.85,1226,89.87,2167504,158878.04,2887,1655,0.77,70,116,0
1301,台塑         ,20130521,15,1.11,47148,3484.24,913,67.47,2166172,160080.11,2320,1402,0.77,15,0,0
1301,台塑         ,20130522,-29,-2.13,47119,3453.82,92,6.74,2166339,158792.65,2727,2685,0.77,0,29,0
1301,台塑         ,20130523,-2,-0.14,47117,3354.73,-4376,-311.57,2163260,154024.11,2460,6217,0.77,0,2,0
1301,台塑         ,20130524,-28,-1.96,47089,3296.23,-8275,-579.25,2156596,150961.72,1190,9296,0.77,0,28,0
1301,台塑         ,20130527,8,0.56,47097,3315.63,-2416,-170.09,2154160,151652.86,1162,3587,0.77,20,12,0
1301,台塑         ,20130528,25,1.78,47122,3345.66,167,11.86,2154435,152964.89,2314,2084,0.77,30,5,0
1301,台塑         ,20130529,-70,-4.98,47052,3345.4,-759,-53.96,2153814,153136.18,1978,2747,0.77,0,70,0
1301,台塑         ,20130530,-155,-10.85,46897,3282.79,-7106,-497.42,2147202,150304.14,896,7700,0.77,0,155,0
1301,台塑         ,20130531,-224,-15.57,46673,3243.77,-3578,-248.67,2143642,148983.12,4806,8142,0.76,26,250,0
1301,台塑         ,20130603,0,0,46673,3243.77,-3017,-209.68,2140421,148759.26,1056,4013,0.76,0,0,0
1301,台塑         ,20130604,-7,-0.49,46666,3261.95,-4517,-315.74,2137544,149414.33,1822,6293,0.76,0,7,0
1301,台塑         ,20130605,0,0,46666,3247.95,-3420,-238.03,2134504,148561.48,1018,4151,0.76,0,0,0
1301,台塑         ,20130606,-35,-2.43,46631,3236.19,-4294,-298,2130371,147847.75,902,5127,0.76,0,35,0
1301,台塑         ,20130607,287,20.06,46918,3279.57,-3738,-261.29,2125662,148583.77,621,4630,0.77,308,21,0
1301,台塑         ,20130610,-20,-1.4,46898,3282.86,-2338,-163.66,2122759,148593.13,1223,3668,0.77,15,35,0
1301,台塑         ,20130611,42,2.92,46940,3262.33,-6547,-455.02,2116228,147077.85,1252,7870,0.77,42,0,0
1301,台塑         ,20130613,-268,-18.33,46672,3192.36,-9896,-676.89,2106682,144097.05,1301,11009,0.76,35,303,0
1301,台塑         ,20130614,-111,-7.6,46561,3189.43,-5932,-406.34,2101992,143986.45,1441,7244,0.76,0,111,0
1301,台塑         ,20130617,157,10.94,46718,3256.24,-2097,-146.16,2100949,146436.15,910,3224,0.76,229,72,0
1301,台塑         ,20130618,37,2.55,46755,3226.1,-4476,-308.84,2096877,144684.51,1002,5511,0.76,41,4,0
1301,台塑         ,20130619,137,9.54,46892,3263.68,-1801,-125.35,2095774,145865.87,1436,3479,0.77,187,50,0
1301,台塑         ,20130620,0,0,46892,3216.79,-4479,-307.26,2091259,143460.37,1054,5621,0.77,0,0,0
1301,台塑         ,20130621,-177,-12,46715,3167.28,-6564,-445.04,2084865,141353.85,15113,21454,0.76,7,184,0
1301,台塑         ,20130624,15,1.03,46730,3196.33,-3110,-212.72,2081308,142361.47,2465,5849,0.76,22,7,0
1301,台塑         ,20130625,0,0,46730,3186.99,719,49.04,2078214,141734.19,3266,2910,0.76,0,0,0
1301,台塑         ,20130626,-10,-0.69,46720,3214.34,-1294,-89.03,2076099,142835.61,4561,5812,0.76,0,10,0
1301,台塑         ,20130627,52,3.65,46772,3283.39,1683,118.15,2077558,145844.57,3833,2216,0.76,52,0,0
1301,台塑         ,20130628,1,0.07,46328,3358.78,1239,89.83,2078414,150685.02,5813,4311,0.76,1,0,0
1301,台塑         ,20130701,-105,-7.46,46223,3281.83,348,24.71,2078304,147559.58,2584,1948,0.76,0,105,0
1301,台塑         ,20130702,-87,-6.06,46136,3215.68,-1250,-87.13,2077282,144786.56,2926,4074,0.75,0,87,0
1301,台塑         ,20130703,-317,-21.87,45819,3161.51,-239,-16.49,2077066,143317.55,1712,1681,0.75,0,317,0
1301,台塑         ,20130704,0,0,45819,3193.58,1320,92,2078406,144864.9,1471,231,0.75,0,0,0
1301,台塑         ,20130705,-38,-2.69,45781,3245.87,2049,145.27,2079855,147461.72,2423,519,0.75,31,69,0
1301,台塑         ,20130708,0,0,45781,3227.56,-1114,-78.54,2078731,146550.54,3663,4662,0.75,0,0,0
1301,台塑         ,20130709,89,6.43,45870,3316.4,416,30.08,2079187,150325.22,4794,5753,0.75,89,0,0
1301,台塑         ,20130710,0,0,45870,3334.75,3230,234.82,2080029,151218.11,5217,1617,0.75,0,0,0
1301,台塑         ,20130711,19,1.44,45889,3414.14,9559,711.19,2088785,155405.6,9337,676,0.75,31,12,0
1301,台塑         ,20130712,-11,-0.83,45878,3440.85,4191,314.33,2092638,156947.85,5300,647,0.75,0,11,0
1301,台塑         ,20130715,99,7.55,45977,3508.05,5957,454.52,2098609,160123.87,6546,892,0.75,99,0,0
1301,台塑         ,20130716,74,5.65,46051,3518.3,8332,636.56,2106794,160959.06,8713,1826,0.75,97,23,0
1301,台塑         ,20130717,688,51.6,48581,3643.58,8474,635.55,2117240,158793,12084,2363,0.79,752,64,0.01
1301,台塑         ,20130718,839,62.84,49420,3701.56,4360,326.56,2120956,158859.6,5758,1968,0.81,844,5,0.01
1301,台塑         ,20130719,227,16.87,49647,3688.77,2322,172.52,2123056,157743.06,3681,1679,0.81,260,33,0
1301,台塑         ,20130722,709,54.17,50356,3847.2,5655,432.04,2127825,162565.83,6508,1958,0.82,709,0,0.01
1301,台塑         ,20130723,2160,168.48,52516,4096.25,10902,850.36,2137364,166714.39,9949,1242,0.86,2160,0,0.02
1301,台塑         ,20130724,199,15.42,52715,4085.41,2596,201.19,2138929,165767,3655,1209,0.86,199,0,0
1301,台塑         ,20130725,-61,-4.68,52654,4038.56,1317,101.01,2140675,164189.77,3311,1788,0.86,27,88,0
1301,台塑         ,20130726,0,0,52654,3975.38,807,60.93,2139577,161538.06,2298,1319,0.86,0,0,0
1301,台塑         ,20130729,43,3.26,52697,3994.43,1690,128.1,2141277,162308.8,3238,1374,0.86,100,57,0
1301,台塑         ,20130730,177,13.52,52874,4039.57,3050,233.02,2144377,163830.4,4294,1553,0.86,186,9,0
1301,台塑         ,20130731,-294,-22.17,52580,3964.53,1644,123.96,2144664,161707.67,5192,3267,0.86,165,459,0.01
1301,台塑         ,20130801,90,6.76,52670,3955.52,1549,116.33,2146313,161188.11,2890,1381,0.86,90,0,0
1301,台塑         ,20130802,0,0,52670,4097.73,9893,769.68,2155443,167693.47,9680,684,0.86,0,0,0
1301,台塑         ,20130805,32,2.5,52702,4110.76,3436,268.01,2158649,168374.62,5173,1329,0.86,32,0,0
1301,台塑         ,20130806,5,0.38,52707,3995.19,-4231,-320.71,2154427,163305.57,702,4656,0.86,100,95,0
1301,台塑         ,20130807,-170,-12.72,52537,3929.77,-1695,-126.79,2153657,161093.54,2474,3696,0.86,0,170,0
1301,台塑         ,20130808,0,0,52537,3924.51,-1157,-86.43,2153017,160830.37,3274,4426,0.86,0,0,0
1301,台塑         ,20130809,29,2.13,52566,3858.34,-2394,-175.72,2150760,157865.78,3493,5779,0.86,29,0,0
1301,台塑         ,20130812,0,0,52566,3910.91,271,20.16,2151002,160034.55,1763,1696,0.86,0,0,0
1301,台塑         ,20130813,0,0,52566,3910.91,-82,-6.1,2231858,166050.24,2325,2351,0.86,0,0,0
1301,台塑         ,20130814,-80,-5.9,52486,3873.47,-3359,-247.89,2228694,164477.62,3106,6128,0.86,95,175,0
1301,台塑         ,20130815,-391,-28.54,52095,3802.94,-4879,-356.17,2224444,162384.41,1726,6174,0.85,0,391,0
1301,台塑         ,20130816,2,0.15,52097,3834.34,-920,-67.71,2223776,163669.91,2009,3033,0.85,2,0,0
1301,台塑         ,20130819,7,0.51,52104,3777.54,-4211,-305.3,2219957,160946.88,2024,6346,0.85,7,0,0
1301,台塑         ,20130820,-51,-3.7,52053,3773.84,-2487,-180.31,2217403,160761.72,2356,4859,0.85,3,54,0
1301,台塑         ,20130822,-39,-2.77,52014,3692.99,-9063,-643.47,2208200,156782.2,2615,11678,0.85,7,46,0
1301,台塑         ,20130823,-54,-3.92,51960,3767.1,-679,-49.23,2206906,160000.69,2574,3508,0.85,26,80,0
1301,台塑         ,20130826,30,2.18,51990,3784.87,-2270,-165.26,2205012,160524.87,258,2376,0.85,30,0,0
1301,台塑         ,20130827,-46,-3.32,51944,3750.36,-2384,-172.12,2202632,159030.03,603,2987,0.85,0,46,0
1301,台塑         ,20130828,11,0.79,51955,3740.76,-511,-36.79,2202241,158561.35,1179,1940,0.85,11,0,0
1301,台塑         ,20130829,0,0,51955,3844.67,3137,232.14,2205501,163207.07,4358,1452,0.85,0,0,0
1301,台塑         ,20130830,83,6.19,52038,3882.03,-324,-24.17,2204955,164489.64,2470,2637,0.85,89,6,0
1301,台塑         ,20130902,0,0,52038,3902.85,1622,121.65,2206656,165499.2,2399,708,0.82,0,0,0
1301,台塑         ,20130903,38,2.84,52076,3931.74,1126,85.01,2207796,166688.6,2477,1375,0.82,38,0,0
1301,台塑         ,20130904,0,0,52076,3957.78,1733,131.71,2209048,167887.65,2770,1042,0.82,0,0,0
1301,台塑         ,20130905,-8,-0.62,52068,4004.03,3866,297.3,2213219,170196.54,5683,1750,0.82,0,8,0
1301,台塑         ,20130906,8,0.61,52076,3957.78,1509,114.68,2214791,168324.12,2986,1442,0.82,8,0,0
1301,台塑         ,20130909,-3,-0.23,52073,4009.62,4722,363.59,2219838,170927.53,5782,749,0.82,0,3,0
1301,台塑         ,20130910,0,0.02,52073,4009.62,3078,237.01,2223114,171179.78,4857,1601,0.82,1,1,0
1301,台塑         ,20130911,14,1.03,52087,3984.66,-377,-28.84,2222931,170054.22,5693,6250,0.82,33,19,0
1301,台塑         ,20130912,4,0.31,52091,4011.01,2751,211.83,2225715,171380.06,4158,1378,0.82,4,0,0
1301,台塑         ,20130913,-91,-6.93,52000,3962.4,360,27.43,2226189,169635.6,1991,1426,0.82,0,91,0
1301,台塑         ,20130914,0,0,52000,3957.2,607,46.19,2226813,169460.47,624,0,0.82,0,0,0
1301,台塑         ,20130916,4,0.31,52004,4040.71,-975,-75.76,2227729,173094.54,5532,6937,0.82,4,0,0
1301,台塑         ,20130917,0,0,52004,4030.31,-3660,-283.65,2224540,172401.85,2778,6360,0.82,0,0,0
1301,台塑         ,20130918,-779,-59.67,51225,3923.84,-2904,-222.45,2221695,170181.84,2492,4409,0.8,8,787,0.01
1301,台塑         ,20130923,-1,-0.08,51224,3944.25,-810,-62.37,2220917,171010.61,3573,4350,0.8,0,1,0
1301,台塑         ,20130924,-41,-3.17,51183,3951.33,-1329,-102.6,2219774,171366.55,3149,4237,0.8,0,41,0
1301,台塑         ,20130925,-7,-0.55,51176,3966.14,909,70.45,2220987,172126.49,3711,2651,0.8,0,7,0
1301,台塑         ,20130926,2,0.15,51178,3930.47,-1346,-103.37,2219945,170491.78,767,1832,0.8,2,0,0
1301,台塑         ,20130927,-21,-1.63,51157,3964.67,-2161,-167.48,2217792,171878.88,2023,4155,0.8,3,24,0
1301,台塑         ,20130930,0,0,52215,3984,-3852,-293.91,2214571,168971.77,1574,5557,0.82,3,3,0
1301,台塑         ,20131001,-126,-9.7,52089,4010.85,-1666,-128.28,2212905,170393.69,1313,3136,0.82,2,128,0
1301,台塑         ,20131002,-32,-2.48,52057,4039.62,-910,-70.62,2211995,171650.81,3787,4819,0.82,0,32,0
1301,台塑         ,20131003,307,24.44,52364,4168.17,5399,429.76,2217644,176524.46,9262,5583,0.82,307,0,0
1301,台塑         ,20131004,1,0.08,52365,4136.84,-1384,-109.34,2216260,175084.54,3377,4895,0.82,1,0,0
1301,台塑         ,20131007,314,24.37,52679,4087.89,-2034,-157.84,2214226,171823.94,1243,3738,0.83,314,0,0
1301,台塑         ,20131008,295,23.01,52974,4131.97,-326,-25.43,2214470,172728.66,2876,3462,0.83,295,0,0
1301,台塑         ,20131009,0,0,52974,4131.97,-1076,-83.93,2213394,172644.73,2821,3814,0.83,0,0,0
1301,台塑         ,20131011,78,6.05,53052,4111.53,-3873,-300.16,2209521,171237.88,1760,5815,0.83,78,0,0
1301,台塑         ,20131014,-3,-0.2,53049,4063.55,-712,-54.54,2208808,169194.69,1038,1764,0.83,0,3,0
1301,台塑         ,20131015,527,40.95,53576,4162.86,-521,-40.48,2208574,171606.2,2360,3298,0.84,600,73,0.01
1301,台塑         ,20131016,80,6.22,53656,4174.44,-2912,-226.55,2205782,171609.84,940,3834,0.84,139,59,0
1301,台塑         ,20131017,201,15.92,53857,4265.47,-764,-60.51,2205246,174655.48,3484,4791,0.85,201,0,0
1301,台塑         ,20131018,65,5.15,53922,4270.62,214,16.95,2206456,174751.32,2540,2295,0.85,85,20,0
1301,台塑         ,20131021,280,22.26,54202,4309.06,283,22.5,2206925,175450.54,875,724,0.85,280,0,0
1301,台塑         ,20131022,54,4.31,54256,4329.63,497,39.66,2207744,176177.97,1666,1013,0.85,102,48,0
1301,台塑         ,20131023,419,33.35,54675,4352.13,71,5.65,2208467,175793.97,1562,1503,0.86,459,40,0
1301,台塑         ,20131024,173,13.77,54848,4365.9,-510,-40.6,2207978,175755.05,322,1021,0.86,173,0,0
1301,台塑         ,20131025,0,0,54848,4332.99,-3250,-256.75,2204777,174177.38,645,3488,0.86,0,0,0
1301,台塑         ,20131028,422,33.3,55270,4360.8,-911,-71.88,2204037,173898.52,1992,3320,0.87,500,78,0
1301,台塑         ,20131029,-2,-0.16,55268,4388.28,443,35.17,2204610,175046.03,2809,2977,0.87,0,2,0
1301,台塑         ,20131030,25,1.99,55293,4395.79,836,66.46,2205456,175333.75,1981,965,0.87,25,0,0
1301,台塑         ,20131031,0,0,55293,4412.38,1070,85.39,2205166,175972.25,3201,2114,0.87,0,0,0
1301,台塑         ,20131101,-135,-10.69,55158,4357.48,-28,-2.21,2205160,174207.64,468,359,0.87,0,135,0
1301,台塑         ,20131104,-129,-9.97,55029,4253.74,-1737,-134.27,2202553,170257.35,62,1713,0.86,0,129,0
1301,台塑         ,20131105,-345,-26.22,54684,4155.98,-2907,-220.93,2199740,167180.24,404,3096,0.86,0,345,0
1301,台塑         ,20131106,-30,-2.28,54654,4153.7,-1415,-107.54,2198335,167073.46,921,2276,0.86,0,30,0
1301,台塑         ,20131107,0,0,54654,4175.57,-1550,-118.42,2196924,167844.99,1057,2604,0.86,0,0,0
1301,台塑         ,20131108,500,37.95,55154,4186.19,-819,-62.16,2196192,166690.97,673,2003,0.87,500,0,0
1301,台塑         ,20131111,0,0,55154,4175.16,-1340,-101.44,2194830,166148.63,744,2181,0.87,0,0,0
1301,台塑         ,20131112,1,0.08,55155,4230.39,867,66.5,2195669,168407.81,1686,1007,0.87,1,0,0
1301,台塑         ,20131113,66,4.95,55221,4141.58,-4014,-301.05,2191989,164399.18,710,4883,0.87,68,2,0
1301,台塑         ,20131114,0,0,55221,4097.4,-3244,-240.7,2188370,162377.05,531,3772,0.87,0,0,0
1301,台塑         ,20131115,0,0,55221,4185.75,-707,-53.59,2187580,165818.56,887,2111,0.87,0,0,0
1301,台塑         ,20131118,0,0,55221,4191.27,-1138,-86.37,2186415,165948.9,335,1676,0.87,0,0,0
1301,台塑         ,20131119,-23,-1.75,55198,4200.57,-699,-53.19,2185578,166322.49,1170,1736,0.87,0,23,0
1301,台塑         ,20131120,-120,-9.01,55078,4136.36,-1836,-137.88,2183776,164001.58,1254,2945,0.87,0,120,0
1301,台塑         ,20131121,3,0.22,55081,4081.5,-3732,-276.54,2178800,161449.08,563,4245,0.87,75,72,0
1301,台塑         ,20131122,-21,-1.58,55060,4135.01,-1437,-107.92,2177202,163507.87,542,1832,0.86,0,21,0
1301,台塑         ,20131125,-2,-0.17,55058,4173.4,431,32.67,2176948,165012.66,1126,826,0.86,0,2,0
1301,台塑         ,20131126,-800,-60.32,54258,4091.05,-782,-58.96,2176166,164082.92,4124,4462,0.85,0,800,0.01
1301,台塑         ,20131127,-19,-1.44,54239,4122.16,-515,-39.14,2175606,165346.06,517,970,0.85,0,19,0
1301,台塑         ,20131128,-28,-2.17,54211,4195.93,1154,89.32,2176760,168481.22,2119,1053,0.85,0,28,0
1301,台塑         ,20131129,-45,-3.5,54166,4214.11,489,38.04,2175550,169257.79,1709,1309,0.85,0,45,0
1301,台塑         ,20131202,152,11.86,54318,4236.8,-380,-29.64,2175224,169667.47,484,962,0.85,500,348,0.01
1301,台塑         ,20131203,-10,-0.77,54308,4203.44,-613,-47.45,2174698,168321.63,708,1223,0.85,0,10,0
1301,台塑         ,20131204,-36,-2.81,54272,4233.22,-6,-0.47,2174631,169621.22,1881,1922,0.85,0,36,0
1301,台塑         ,20131205,55,4.3,54327,4242.94,-1039,-81.15,2173692,169765.35,1062,2056,0.85,116,61,0
1301,台塑         ,20131206,0,0,54327,4188.61,-2969,-228.91,2170693,167360.43,703,3702,0.85,0,0,0
1301,台塑         ,20131209,150,11.84,54477,4298.24,2194,173.11,2172775,171431.95,3563,1621,0.86,150,0,0
1301,台塑         ,20131210,800,63.2,55277,4366.88,1169,92.35,2174045,171749.56,1327,867,0.87,800,0,0.01
1301,台塑         ,20131211,2068,164.82,57345,4570.4,3868,308.28,2178174,173600.47,2486,435,0.9,2100,32,0.02
1301,台塑         ,20131212,1316,103.83,58661,4628.35,42,3.31,2178201,171860.06,623,1891,0.92,1318,2,0.01
1301,台塑         ,20131213,528,41.76,59189,4681.85,334,26.42,2178521,172321.01,1182,1390,0.93,529,1,0
1301,台塑         ,20131216,573,44.81,59762,4673.39,-1217,-95.17,2177243,170260.4,452,2302,0.94,588,15,0
1301,台塑         ,20131217,587,45.9,60349,4719.29,-956,-74.76,2176325,170188.62,818,2323,0.95,592,5,0
1301,台塑         ,20131218,-306,-23.9,60043,4689.36,-2015,-157.37,2175134,169877.97,974,2488,0.94,91,397,0
1301,台塑         ,20131219,320,24.99,60363,4714.35,267,20.85,2175332,169893.43,1441,1563,0.95,320,0,0
1301,台塑         ,20131220,-866,-67.2,59497,4616.97,-3438,-266.79,2171813,168532.69,2326,4980,0.93,79,945,0.01
1301,台塑         ,20131223,-25,-1.97,59472,4686.39,-85,-6.7,2171662,171126.97,2095,2221,0.93,30,55,0
1301,台塑         ,20131224,56,4.42,59528,4702.71,422,33.34,2172077,171594.08,784,469,0.94,125,69,0
1301,台塑         ,20131225,600,47.7,60128,4780.18,1106,87.93,2173184,172768.13,580,104,0.94,620,20,0.01
1301,台塑         ,20131226,17,1.34,60145,4757.47,-40,-3.16,2173029,171886.59,153,325,0.94,30,13,0
1301,台塑         ,20131227,218,17.27,60363,4780.75,1667,132.03,2174882,172250.65,2236,749,0.95,218,0,0
1301,台塑         ,20131230,181,14.48,60544,4843.52,1909,152.72,2176879,174150.32,2824,1108,0.95,215,34,0
1301,台塑         ,20131231,-9,-0.72,59302,4773.81,806,64.88,2176451,175204.31,1428,551,0.93,0,9,0
1301,台塑         ,20140102,-47,-3.75,59255,4728.55,-821,-65.52,2176145,173656.37,403,1091,0.93,0,47,0
1301,台塑         ,20140103,-228,-18.13,59027,4692.65,-1993,-158.44,2174152,172845.08,449,2138,0.93,30,258,0
1301,台塑         ,20140106,-103,-8.14,58924,4655,-1060,-83.74,2173092,171674.27,1002,1944,0.93,0,103,0
1301,台塑         ,20140107,-1,-0.08,58923,4619.56,-644,-50.49,2173875,170431.8,1395,2069,0.93,0,1,0
1301,台塑         ,20140108,101,7.88,59024,4603.87,-1677,-130.81,2172198,169431.44,766,2544,0.93,101,0,0
1301,台塑         ,20140109,-8,-0.63,59016,4650.46,-931,-73.36,2171267,171095.84,973,1920,0.93,0,8,0
1301,台塑         ,20140110,-2,-0.16,59014,4650.3,-1322,-104.17,2169945,170991.67,913,2177,0.93,0,2,0
1301,台塑         ,20140113,0,0,59014,4662.11,37,2.92,2169981,171428.5,913,863,0.93,0,0,0
1301,台塑         ,20140114,-101,-7.94,58913,4630.56,-643,-50.54,2169249,170502.97,1044,1549,0.93,3,104,0
1301,台塑         ,20140115,-165,-13.04,58748,4641.09,45,3.56,2169652,171402.51,1584,1288,0.92,0,165,0
1301,台塑         ,20140116,0,0,58748,4652.84,48,3.8,2169946,171859.72,988,776,0.92,0,0,0
1301,台塑         ,20140117,-59,-4.64,58689,4618.82,-971,-76.42,2168985,170699.12,195,1012,0.92,0,59,0
1301,台塑         ,20140120,-15,-1.19,58674,4635.25,388,30.65,2169384,171381.34,613,200,0.92,0,15,0
1301,台塑         ,20140121,-91,-7.23,58583,4657.35,70,5.57,2168955,172431.92,551,554,0.92,0,91,0
1301,台塑         ,20140122,-202,-16.16,58381,4670.48,2709,216.72,2171515,173721.2,3676,851,0.92,0,202,0
1301,台塑         ,20140123,-33,-2.64,58348,4662.01,-270,-21.57,2171107,173471.45,1236,1412,0.92,0,33,0
1301,台塑         ,20140124,-59,-4.73,58289,4668.95,389,31.16,2171541,173940.43,2117,1679,0.92,0,59,0
1301,台塑         ,20140127,-3,-0.23,58286,4546.31,-4726,-368.63,2166276,168969.53,2647,7380,0.92,0,3,0
1301,台塑         ,20140205,0,0,58286,4388.94,-10234,-770.62,2156214,162362.91,5019,15092,0.92,0,0,0
1301,台塑         ,20140206,-30,-2.26,58256,4380.85,-6004,-451.5,2150049,161683.68,3943,9802,0.92,0,30,0
1301,台塑         ,20140207,407,30.69,58663,4423.19,-2886,-217.6,2147162,161896.01,4584,7908,0.92,480,73,0
1301,台塑         ,20140210,-92,-6.96,58571,4427.97,-1751,-132.38,2145416,162193.45,751,2355,0.92,0,92,0
1301,台塑         ,20140211,-2,-0.15,58569,4468.81,-154,-11.75,2145129,163673.34,1275,1465,0.92,0,2,0
1301,台塑         ,20140212,27,2.08,58596,4506.03,-853,-65.6,2144195,164888.6,1357,2342,0.92,130,103,0
1301,台塑         ,20140213,-10,-0.73,58586,4481.83,-607,-46.44,2143599,163985.32,424,1020,0.92,0,10,0
1301,台塑         ,20140214,0,0,58586,4511.12,2085,160.54,2145538,165206.43,3337,1318,0.92,0,0,0
1301,台塑         ,20140217,0,0,58586,4493.55,-230,-17.64,2145299,164544.43,1070,1319,0.92,0,0,0
1301,台塑         ,20140218,0,0,58586,4493.55,-270,-20.71,2144848,164509.84,1974,2225,0.92,0,0,0
1301,台塑         ,20140219,-17,-1.31,58569,4527.38,960,74.21,2145860,165874.98,1911,882,0.92,0,17,0
1301,台塑         ,20140220,-16,-1.22,58553,4473.45,-1057,-80.75,2144859,163867.23,491,1476,0.92,0,16,0
1301,台塑         ,20140221,0,0,58553,4508.58,2407,185.34,2147441,165352.96,2831,433,0.92,0,0,0
1301,台塑         ,20140224,-463,-35.56,58090,4461.31,441,33.87,2147907,164959.26,1340,431,0.91,0,463,0
1301,台塑         ,20140225,-157,-12.12,57933,4472.43,2887,222.88,2151016,166058.44,3716,470,0.91,0,157,0
1301,台塑         ,20140226,-70,-5.43,57863,4484.38,2927,226.84,2153968,166932.52,4165,1168,0.91,0,70,0
1301,台塑         ,20140227,-1312,-101.02,56551,4354.43,-761,-58.6,2153222,165798.09,2373,1827,0.89,0,1312,0.01
1301,台塑         ,20140303,-490,-37.24,56061,4260.64,-2006,-152.46,2151774,163534.82,2539,3792,0.88,0,490,0
1301,台塑         ,20140304,-32,-2.41,56029,4218.98,-1440,-108.43,2150586,161939.13,518,1932,0.88,0,32,0
1301,台塑         ,20140305,-144,-10.87,55885,4219.32,103,7.78,2150701,162377.93,687,428,0.88,0,144,0
1301,台塑         ,20140306,-31,-2.34,55854,4216.98,45,3.4,2150986,162399.44,1680,1374,0.88,0,31,0
1301,台塑         ,20140307,-28,-2.14,55826,4259.52,2605,198.76,2154360,164377.67,3301,323,0.88,0,28,0
1301,台塑         ,20140310,-13,-0.98,55813,4208.3,339,25.56,2154788,162471.02,1565,1229,0.88,0,13,0
1301,台塑         ,20140311,-73,-5.55,55740,4236.24,719,54.64,2155605,163825.98,2617,1817,0.88,0,73,0
1301,台塑         ,20140312,-1362,-102.15,54378,4078.35,-1600,-120,2154208,161565.6,912,1140,0.85,0,1362,0.01
1301,台塑         ,20140313,-598,-44.85,53780,4033.5,1019,76.43,2155397,161654.78,3122,1344,0.84,0,598,0
1301,台塑         ,20140314,-16,-1.18,53764,3951.65,-3773,-277.32,2151767,158154.87,627,4252,0.84,0,16,0
1301,台塑         ,20140317,-613,-44.76,53151,3880.02,-1145,-83.59,2151322,157046.51,652,1028,0.83,0,613,0
1301,台塑         ,20140318,-31,-2.29,53120,3930.88,1301,96.27,2152724,159301.58,3378,1966,0.83,0,31,0
1301,台塑         ,20140319,-75,-5.5,53045,3888.2,-606,-44.42,2151967,157739.18,242,760,0.83,0,75,0
1301,台塑         ,20140320,-1609,-118.74,51436,3795.98,-4410,-325.46,2147856,158511.77,2384,5056,0.81,0,1609,0.01
1301,台塑         ,20140321,-1336,-97.53,50100,3657.3,-3094,-225.86,2145422,156615.81,3237,4984,0.79,0,1336,0.01
1301,台塑         ,20140324,-552,-40.55,49548,3636.82,1329,97.55,2147050,157593.47,2666,806,0.78,0,552,0
1301,台塑         ,20140325,0,0,49548,3696.28,2266,169.04,2149214,160331.36,4297,1843,0.78,0,0,0
1301,台塑         ,20140326,0,0,49548,3666.55,855,63.27,2150152,159111.25,2411,1523,0.78,0,0,0
1301,台塑         ,20140327,0,0,49548,3760.69,5172,392.55,2154833,163551.82,6859,1508,0.78,0,0,0
1301,台塑         ,20140328,-82,-6.23,49466,3759.42,3430,260.68,2158096,164015.3,4191,669,0.78,0,82,0
1301,台塑         ,20140331,0,0,43843,3340.84,1671,127.33,2155058,164215.42,3323,1533,0.69,0,0,0
1301,台塑         ,20140401,-40,-3.05,43803,3342.17,1138,86.83,2157012,164580.02,3067,1673,0.69,0,40,0
1301,台塑         ,20140402,0,0,43803,3364.07,2641,202.83,2160563,165931.24,3059,390,0.69,0,0,0
1301,台塑         ,20140403,-80,-6.17,43723,3371.04,3401,262.22,2164714,166899.45,3873,418,0.69,0,80,0
1301,台塑         ,20140407,-21,-1.62,43702,3369.42,1412,108.87,2165293,166944.09,3592,2162,0.69,0,21,0
1301,台塑         ,20140408,-40,-3.1,43662,3383.8,2244,173.91,2167572,167986.83,4210,1972,0.69,0,40,0
1301,台塑         ,20140409,0,0,43662,3383.8,925,71.69,2168499,168058.67,2217,1305,0.69,0,0,0
1301,台塑         ,20140410,-41,-3.15,43621,3380.63,827,64.09,2169366,168125.87,2722,1844,0.69,9,50,0
1301,台塑         ,20140411,110,8.53,43731,3389.15,837,64.87,2170429,168208.25,1693,955,0.69,160,50,0
1301,台塑         ,20140414,0,0,43731,3389.15,1478,114.55,2171904,168322.56,2494,1019,0.69,0,0,0
1301,台塑         ,20140415,-100,-7.78,43631,3394.49,2044,159.02,2174031,169139.61,4106,1954,0.69,0,100,0
1301,台塑         ,20140416,-1,-0.08,43630,3376.96,1376,106.5,2175965,168419.69,4100,2165,0.69,0,1,0
1301,台塑         ,20140417,-79,-6.13,43551,3379.56,11,0.85,2176051,168861.56,1482,1317,0.68,0,79,0
1301,台塑         ,20140418,-2,-0.16,43549,3388.11,703,54.69,2176784,169353.8,906,171,0.68,0,2,0
1301,台塑         ,20140421,-1,-0.08,43548,3379.32,122,9.47,2176967,168932.64,263,79,0.68,1,2,0
1301,台塑         ,20140422,-4,-0.31,43544,3357.24,-125,-9.64,2177545,167888.72,673,793,0.68,0,4,0
1301,台塑         ,20140423,-1,-0.08,43543,3300.56,-2164,-164.03,2175251,164884.03,705,2523,0.68,0,1,0
1301,台塑         ,20140424,-40,-3.07,43503,3341.03,1205,92.54,2176470,167152.9,2208,949,0.68,0,40,0
1301,台塑         ,20140425,-56,-4.24,43447,3288.94,2384,180.47,2179741,165006.39,4554,1963,0.68,0,56,0
1301,台塑         ,20140428,0,0,43447,3306.32,914,69.56,2180587,165942.67,2678,1832,0.68,0,0,0
1301,台塑         ,20140429,0,0,43447,3341.07,1971,151.57,2182991,167872.01,3126,1090,0.68,0,0,0
1301,台塑         ,20140430,-11,-0.86,43436,3379.32,5726,445.48,2188775,170286.7,10382,4637,0.68,0,11,0
1301,台塑         ,20140502,100,7.78,43536,3387.1,507,39.44,2189312,170328.47,3376,2943,0.68,100,0,0
1301,台塑         ,20140505,0,0,43536,3395.81,374,29.17,2189666,170793.95,1174,770,0.68,0,0,0
1301,台塑         ,20140506,0,0,43536,3382.75,407,31.62,2190123,170172.56,2477,1809,0.68,0,0,0
1301,台塑         ,20140507,0,0,43536,3404.52,-45,-3.52,2190369,171286.86,2890,2664,0.68,0,0,0
1301,台塑         ,20140508,0,0,43536,3369.69,-516,-39.94,2190006,169506.46,1226,1716,0.68,0,0,0
1301,台塑         ,20140509,-1,-0.08,43535,3387.02,160,12.45,2221089,172800.72,1748,1449,0.68,0,1,0
1301,台塑         ,20140512,20,1.54,43555,3353.74,-771,-59.37,2220301,170963.18,488,1297,0.68,20,0,0
1301,台塑         ,20140513,-1,-0.08,43554,3349.3,230,17.69,2220797,170779.29,2555,2308,0.68,0,1,0
1301,台塑         ,20140514,7,0.54,43561,3367.27,741,57.28,2221495,171721.56,3218,2637,0.68,7,0,0
1301,台塑         ,20140515,-1,-0.08,43560,3336.7,213,16.32,2221821,170191.49,1033,833,0.68,0,1,0
1301,台塑         ,20140516,-46,-3.51,43514,3324.47,-339,-25.9,2221428,169717.1,1256,1644,0.68,0,46,0
1301,台塑         ,20140519,-4,-0.31,43510,3358.97,900,69.48,2222205,171554.23,1800,900,0.68,0,4,0
1301,台塑         ,20140520,0,0,43510,3319.81,-279,-21.29,2221938,169533.87,1283,1551,0.68,0,0,0
1301,台塑         ,20140521,0,0,43510,3345.92,646,49.68,2222596,170917.63,1528,890,0.68,0,0,0
1301,台塑         ,20140522,215,16.68,43725,3393.06,1320,102.43,2223826,172568.9,1978,988,0.69,215,0,0
1301,台塑         ,20140523,20,1.55,43745,3390.24,-449,-34.8,2223566,172326.37,1842,2403,0.69,20,0,0
1301,台塑         ,20140526,-4,-0.31,43741,3407.42,1173,91.38,2224744,173307.56,1788,633,0.69,0,4,0
1301,台塑         ,20140527,-28,-2.18,43713,3400.87,54,4.2,2224521,173067.73,394,312,0.69,0,28,0
1301,台塑         ,20140528,4,0.31,43717,3396.81,2096,162.86,2226679,173012.96,4699,2595,0.69,6,2,0
1301,台塑         ,20140529,-8,-0.62,43709,3413.67,1124,87.78,2227810,173991.96,2279,1145,0.69,0,8,0
1301,台塑         ,20140530,74,5.68,43783,3358.16,-1657,-127.09,2226128,170744.02,3949,5705,0.69,80,6,0
1301,台塑         ,20140603,-17,-1.33,43766,3413.75,2003,156.23,2227868,173773.7,3042,1974,0.69,0,17,0
1301,台塑         ,20140604,0,0,43766,3391.86,-177,-13.72,2227687,172645.74,1190,1342,0.69,0,0,0
1301,台塑         ,20140605,0,0,43766,3391.86,-623,-48.28,2227064,172597.46,1195,2083,0.69,0,0,0
1301,台塑         ,20140606,-2,-0.15,43764,3374.2,-202,-15.57,2226859,171690.83,1045,1242,0.69,0,2,0
1301,台塑         ,20140609,-1,-0.08,43763,3374.13,296,22.82,2227160,171714.04,1197,897,0.69,0,1,0
1301,台塑         ,20140610,-11,-0.85,43752,3368.9,422,32.49,2227572,171523.04,2520,2157,0.69,0,11,0
1301,台塑         ,20140611,-18,-1.38,43734,3354.4,148,11.35,2227869,170877.55,3092,3086,0.69,0,18,0
1301,台塑         ,20140612,53,4.05,43787,3349.71,232,17.75,2228100,170449.65,3688,3506,0.69,85,32,0
1301,台塑         ,20140613,-255,-19.56,43532,3338.9,-834,-63.97,2227261,170830.92,3753,4331,0.68,0,255,0
1301,台塑         ,20140616,-22,-1.68,43510,3324.16,-976,-74.57,2224148,169924.91,3223,4171,0.68,0,22,0
1301,台塑         ,20140617,0,0,43510,3341.57,1072,82.33,2216949,170261.68,3391,2410,0.68,0,0,0
1301,台塑         ,20140618,-20,-1.55,43490,3392.22,6332,493.9,2221035,173240.73,8701,1519,0.68,2,22,0
1301,台塑         ,20140619,0,0,43490,3448.76,4578,363.04,2222379,176234.65,5116,465,0.68,0,0,0
1301,台塑         ,20140620,-308,-24.14,43182,3389.79,-536,-42.08,2217583,174080.27,3010,3332,0.68,0,308,0
1301,台塑         ,20140623,650,51.55,43832,3475.88,3268,259.15,2219105,175975.03,3009,511,0.69,650,0,0.01
1301,台塑         ,20140624,1181,94.36,45013,3596.54,2191,175.06,2217054,177142.61,2374,1628,0.71,1191,10,0.01
1301,台塑         ,20140625,94,7.44,45107,3567.96,61,4.83,2217115,175373.8,837,566,0.71,100,6,0
1301,台塑         ,20140626,6,0.48,45113,3600.02,1146,91.45,2218247,177016.11,1830,488,0.71,6,0,0
1301,台塑         ,20140627,62,4.95,45175,3604.97,-452,-36.07,2216654,176888.99,1107,1287,0.71,62,0,0
1301,台塑         ,20140630,-27,-2.15,67156,5359.05,39,3.11,2238727,178650.41,1244,1170,1.05,1,28,0
1301,台塑         ,20140701,131,10.48,67287,5382.96,978,78.24,2239643,179171.44,1979,1723,1.06,164,33,0
1301,台塑         ,20140702,490,39.3,67777,5435.72,2297,184.22,2241940,179803.59,1900,1269,1.06,493,3,0
1301,台塑         ,20140703,2,0.16,67779,5259.65,-3511,-272.45,2231908,173196.06,1607,1491,1.06,2,0,0
1301,台塑         ,20140704,0,0,67779,5252.87,-1090,-84.48,2231270,172923.43,806,1444,1.06,0,0,0
1301,台塑         ,20140707,0,0,67779,5218.98,66,5.08,2231485,171824.35,1448,1233,1.06,0,0,0
1301,台塑         ,20140708,199,15.4,67978,5261.5,1177,91.1,2232730,172813.3,1292,256,1.07,200,1,0
1301,台塑         ,20140709,0,0,67978,5227.51,97,7.46,2232900,171710.01,508,338,1.07,0,0,0
1301,台塑         ,20140710,0,0,67978,5268.3,1941,150.43,2234588,173180.57,3330,1255,1.07,0,0,0
1301,台塑         ,20140711,0,0,67978,5254.7,1325,102.42,2236088,172849.6,2201,800,1.07,0,0,0
1301,台塑         ,20140714,0,0,67978,5247.9,776,59.91,2236749,172677.02,4373,3592,1.07,0,0,0
1301,台塑         ,20140715,-276,-21.47,67702,5267.22,991,77.1,2238002,174116.56,4090,2562,1.06,0,276,0
1301,台塑         ,20140716,0,0,67702,5192.74,-4313,-330.81,2234080,171353.94,1796,5869,1.06,0,0,0
1301,台塑         ,20140717,-72,-5.52,67630,5180.46,-652,-49.94,2240682,171636.24,2271,2786,1.06,28,100,0
1301,台塑         ,20140718,-38,-2.91,67592,5177.55,-954,-73.08,2239712,171561.94,2257,3189,1.06,0,38,0
1301,台塑         ,20140721,0,0,67592,5211.34,-483,-37.24,2239287,172649.03,2497,2921,1.06,0,0,0
1301,台塑         ,20140722,21,1.62,67613,5219.72,779,60.14,2239961,172924.99,4650,3900,1.06,21,0,0
1301,台塑         ,20140724,1190,91.63,68803,5297.83,-641,-49.36,2239312,172427.02,2170,3960,1.08,1190,0,0.01
1301,台塑         ,20140725,945,72.77,69748,5370.6,566,43.58,2239826,172466.6,2136,2562,1.1,1206,261,0.01
1301,台塑         ,20140728,735,57.11,70483,5476.53,3020,234.65,2243180,174295.09,4452,1833,1.11,735,0,0.01
1301,台塑         ,20140729,7,0.54,70490,5477.07,1982,154,2245008,174437.12,4911,3045,1.11,7,0,0
1301,台塑         ,20140730,35,2.75,70525,5550.32,2398,188.72,2247561,176883.05,3670,1152,1.11,37,2,0
1301,台塑         ,20140731,47,3.63,70572,5455.22,-673,-52.02,2246627,173664.27,2588,3238,1.11,47,0,0
1301,台塑         ,20140801,96,7.36,70668,5420.24,100,7.67,2247396,172375.27,1260,1246,1.11,96,0,0
1301,台塑         ,20140804,-15,-1.13,70653,5313.11,-4002,-300.95,2243224,168690.44,1158,5043,1.11,0,15,0
1301,台塑         ,20140805,-258,-19.17,70395,5230.35,-5286,-392.75,2237959,166280.35,1951,6754,1.11,0,258,0
1301,台塑         ,20140806,10,0.76,70405,5364.86,2409,183.57,2240268,170708.42,3402,897,1.11,10,0,0
1301,台塑         ,20140807,42,3.16,70447,5304.66,-1654,-124.55,2238691,168573.43,583,2202,1.11,42,0,0
1301,台塑         ,20140808,34,2.55,70481,5286.08,-580,-43.5,2239927,167994.53,693,1312,1.11,57,23,0
1301,台塑         ,20140811,-106,-8,70375,5313.31,-403,-30.43,2239523,169083.99,354,653,1.11,19,125,0
1301,台塑         ,20140812,7,0.53,70382,5327.92,-568,-43,2239235,169510.09,1467,1762,1.11,7,0,0
1301,台塑         ,20140813,157,11.92,70539,5353.91,914,69.37,2240121,170025.18,1600,871,1.11,284,127,0
1301,台塑         ,20140814,24,1.81,70563,5327.51,-311,-23.48,2240846,169183.87,1108,1217,1.11,24,0,0
1301,台塑         ,20140815,10,0.76,70573,5384.72,1558,118.88,2242454,171099.24,2204,618,1.11,10,0,0
1301,台塑         ,20140818,2,0.15,70575,5321.36,-175,-13.2,2244681,169248.95,749,878,1.11,2,0,0
1301,台塑         ,20140819,7,0.54,70582,5420.7,1739,133.56,2246463,172528.36,2124,349,1.11,7,0,0
1301,台塑         ,20140820,4,0.31,70586,5456.3,1032,79.77,2247862,173759.73,2259,1100,1.11,4,0,0
1301,台塑         ,20140821,49,3.77,70635,5431.83,203,15.61,2248083,172877.58,1294,1136,1.11,49,0,0
1301,台塑         ,20140822,0,0,70635,5516.59,4135,322.94,2252205,175897.21,4921,815,1.11,0,0,0
1301,台塑         ,20140825,0,0,70635,5509.53,282,22,2252409,175687.9,1159,898,1.11,0,0,0
1301,台塑         ,20140826,3,0.23,70638,5509.76,899,70.12,2253113,175742.81,1868,1095,1.11,3,0,0
1301,台塑         ,20140827,2,0.16,70640,5552.3,3114,244.76,2256109,177330.17,4631,1520,1.11,2,0,0
1301,台塑         ,20140828,55,4.32,70695,5549.56,463,36.35,2261747,177547.14,2127,1763,1.11,55,0,0
1301,台塑         ,20140829,1,0.08,70696,5478.94,-1230,-95.33,2263898,175452.1,2422,3603,1.11,1,0,0
1301,台塑         ,20140901,0,0,70696,5478.94,1769,137.1,2265173,175550.91,2419,645,1.11,0,0,0
1301,台塑         ,20140902,0,0,70696,5471.87,-107,-8.28,2265278,175332.52,1611,1662,1.11,0,0,0
1301,台塑         ,20140903,-379,-29.37,70317,5449.57,526,40.77,2274682,176287.86,1863,941,1.1,21,400,0
1301,台塑         ,20140904,448,34.99,70765,5526.75,1152,89.97,2275685,177731,1584,874,1.11,448,0,0
1301,台塑         ,20140905,297,23.17,71062,5542.84,656,51.17,2276837,177593.29,894,535,1.12,297,0,0
1301,台塑         ,20140909,70,5.41,71132,5498.5,-15,-1.16,2276822,175998.34,824,909,1.12,70,0,0
1301,台塑         ,20140910,0,0,71132,5391.81,-2529,-191.7,2275601,172490.56,594,3121,1.12,0,0,0
1301,台塑         ,20140911,66,4.98,71198,5375.45,-887,-66.97,2274736,171742.57,348,1279,1.12,66,0,0
1301,台塑         ,20140912,422,31.82,71620,5400.15,-445,-33.55,2274337,171485.01,418,1238,1.13,422,0,0
1301,台塑         ,20140915,435,32.76,72055,5425.74,397,29.89,2274389,171261.49,1040,1063,1.13,435,0,0
1301,台塑         ,20140916,-189,-14.18,71866,5389.95,-1098,-82.35,2273278,170495.85,744,1666,1.13,11,200,0
1301,台塑         ,20140917,-265,-19.93,71601,5384.4,-403,-30.31,2271971,170852.22,2551,2860,1.12,14,279,0
1301,台塑         ,20140918,74,5.56,71675,5382.79,706,53.02,2272553,170668.73,1223,594,1.13,100,26,0
1301,台塑         ,20140919,-165,-12.34,71510,5348.95,-144,-10.77,2272135,169955.7,1999,2050,1.12,2,167,0
1301,台塑         ,20140922,29,2.17,71539,5258.12,-3292,-241.96,2268922,166765.77,1172,4570,1.12,29,0,0
1301,台塑         ,20140923,-194,-14.26,71345,5243.86,-983,-72.25,2267529,166663.38,1198,2136,1.12,3,197,0
1301,台塑         ,20140924,3,0.22,71348,5229.81,-253,-18.54,2267182,166184.44,872,1207,1.12,3,0,0
1301,台塑         ,20140925,15,1.1,71363,5209.5,-1691,-123.44,2268000,165564,2489,4188,1.12,100,85,0
1301,台塑         ,20140926,0,0,71363,5245.18,-1189,-87.39,2267674,166674.04,2900,4101,1.12,0,0,0
1301,台塑         ,20140929,0,0,71363,5138.14,-5151,-370.87,2263804,162993.89,3485,8653,1.12,0,0,0
1301,台塑         ,20140930,38,2.74,47142,3398.94,-1852,-133.53,2236721,161267.58,4580,6528,0.74,38,0,0
1301,台塑         ,20141001,0,0,47142,3365.94,-1985,-141.73,2234604,159550.73,1709,3719,0.74,0,0,0
1301,台塑         ,20141002,1,0.07,47143,3342.44,-2712,-192.28,2232053,158252.56,2141,4842,0.74,1,0,0
1301,台塑         ,20141003,0,0,47143,3370.72,-2113,-151.08,2231018,159517.79,1298,3286,0.74,0,0,0
1301,台塑         ,20141006,-390,-27.65,46753,3314.79,-3760,-266.58,2228517,158001.86,1422,4775,0.73,10,400,0
1301,台塑         ,20141007,-397,-28.11,46356,3282,-914,-64.71,2227528,157708.98,4030,4532,0.73,3,400,0
1301,台塑         ,20141008,-496,-35.27,45860,3260.65,-296,-21.05,2227124,158348.52,3509,3417,0.72,3,499,0
1301,台塑         ,20141009,-1,-0.07,45859,3255.99,97,6.89,2227835,158176.29,4350,4306,0.72,0,1,0
1301,台塑         ,20141013,0,0,45859,3187.2,-4715,-327.69,2223323,154520.95,2072,6657,0.72,0,0,0
1301,台塑         ,20141014,1,0.07,45860,3182.68,-2015,-139.84,2221467,154169.81,2615,4444,0.72,1,0,0
1301,台塑         ,20141015,-329,-22.37,45531,3096.11,-4140,-281.52,2217473,150788.16,3637,7191,0.72,6,335,0
1301,台塑         ,20141016,200,13.54,45731,3095.99,81,5.48,2218076,150163.75,4054,4171,0.72,200,0,0
1301,台塑         ,20141017,3,0.2,45734,2991,-9643,-630.65,2208594,144442.05,15364,24990,0.72,3,0,0
1301,台塑         ,20141020,0,0,45734,3027.59,-1930,-127.77,2206347,146060.17,3262,5242,0.72,0,0,0
1301,台塑         ,20141021,14,0.93,45748,3033.09,-3847,-255.06,2201369,145950.76,1153,5009,0.72,14,0,0
1301,台塑         ,20141022,435,29.54,46183,3135.83,-2626,-178.31,2199087,149318.01,2060,5222,0.73,435,0,0
1301,台塑         ,20141023,566,38.49,46749,3178.93,-952,-64.74,2198818,149519.62,954,2470,0.73,566,0,0
1301,台塑         ,20141024,540,36.5,47289,3196.74,-2998,-202.66,2196087,148455.48,725,4263,0.74,540,0,0
1301,台塑         ,20141027,546,37.13,47835,3252.78,147,10,2197361,149420.55,1790,2218,0.75,547,1,0
1301,台塑         ,20141028,0,0,47835,3281.48,1729,118.61,2198583,150822.79,4012,2458,0.75,0,0,0
1301,台塑         ,20141029,159,11.1,47994,3349.98,779,54.37,2199802,153546.18,4000,3163,0.75,159,0,0
1301,台塑         ,20141030,226,15.89,48220,3389.87,515,36.2,2200287,154680.18,2801,2418,0.76,226,0,0
1301,台塑         ,20141031,28,1.97,48248,3387.01,-374,-26.25,2199846,154429.19,2357,2739,0.76,31,3,0
1301,台塑         ,20141103,-5,-0.35,48243,3401.13,617,43.5,2200764,155153.86,1688,948,0.76,0,5,0
1301,台塑         ,20141104,0,0,48243,3396.31,1109,78.07,2201935,155016.22,2463,1358,0.76,0,0,0
1301,台塑         ,20141105,0,0,48243,3367.36,-50,-3.49,2197512,153386.34,1591,1673,0.76,0,0,0
1301,台塑         ,20141106,0,0,48243,3377.01,660,46.2,2198089,153866.23,1489,1010,0.76,0,0,0
1301,台塑         ,20141107,-23,-1.59,48220,3341.65,-614,-42.55,2197475,152285.02,339,995,0.76,0,23,0
1301,台塑         ,20141110,-560,-39.2,47660,3336.2,918,64.26,2198792,153915.44,3638,2227,0.75,0,560,0
1301,台塑         ,20141111,32,2.23,47692,3319.36,-444,-30.9,2198472,153013.65,1779,2355,0.75,32,0,0
1301,台塑         ,20141112,-381,-26.1,47311,3240.8,-2271,-155.56,2196365,150451,1996,3890,0.74,15,396,0
1301,台塑         ,20141113,0,0,47311,3231.34,-789,-53.89,2195976,149985.16,1285,2011,0.74,0,0,0
1301,台塑         ,20141114,0,0,47311,3217.15,-847,-57.6,2195839,149317.05,1193,1944,0.74,0,0,0
1301,台塑         ,20141117,-42,-2.84,47269,3200.11,-1141,-77.25,2194962,148598.93,1058,2181,0.74,0,42,0
1301,台塑         ,20141118,0,0,47269,3266.29,1561,107.87,2196240,151760.18,2261,830,0.74,0,0,0
1301,台塑         ,20141119,0,0,47269,3299.38,1813,126.55,2199982,153558.74,5741,3988,0.74,0,0,0
1301,台塑         ,20141120,6,0.42,47275,3318.71,-85,-5.97,2199745,154422.1,1542,1648,0.74,6,0,0
1301,台塑         ,20141121,85,5.95,47360,3315.2,-1016,-71.12,2198670,153906.9,585,1689,0.74,85,0,0
1301,台塑         ,20141124,896,63.8,48256,3435.83,1241,88.36,2199872,156630.89,1297,997,0.76,896,0,0.01
1301,台塑         ,20141125,0,0,48256,3397.22,-339,-23.87,2200115,154888.1,4186,4565,0.76,2,2,0
1301,台塑         ,20141126,276,19.43,48532,3416.65,-159,-11.19,2199973,154878.1,585,1020,0.76,277,1,0
1301,台塑         ,20141127,19,1.34,48551,3427.7,1041,73.49,2201003,155390.81,1426,388,0.76,23,4,0
1301,台塑         ,20141128,330,23.43,48881,3470.55,503,35.71,2201085,156277.04,1598,1422,0.77,330,0,0
1301,台塑         ,20141201,0,0,48881,3407.01,-2915,-203.18,2197904,153193.91,406,3345,0.77,0,0,0
1301,台塑         ,20141202,-202,-14.08,48679,3392.93,-2894,-201.71,2196539,153098.77,1320,3937,0.76,0,202,0
1301,台塑         ,20141203,-136,-9.6,48543,3431.99,-181,-12.8,2196360,155282.65,1269,1295,0.76,120,256,0
1301,台塑         ,20141204,0,0,48543,3446.55,738,52.4,2197065,155991.62,2214,1429,0.76,0,0,0
1301,台塑         ,20141205,-57,-4.05,48486,3442.51,-186,-13.21,2196892,155979.33,626,742,0.76,0,57,0
1301,台塑         ,20141208,-4,-0.28,48482,3422.83,78,5.51,2197356,155133.33,696,610,0.76,0,4,0
1301,台塑         ,20141209,0,0,48482,3384.04,-626,-43.69,2196723,153331.27,1331,1965,0.76,0,0,0
1301,台塑         ,20141210,-111,-7.64,48371,3327.92,-2352,-161.82,2194284,150966.74,1443,3684,0.76,0,111,0
1301,台塑         ,20141211,62,4.24,48433,3293.44,-1316,-89.49,2193216,149138.69,747,2127,0.76,67,5,0
1301,台塑         ,20141212,0,0,48433,3259.54,-2322,-156.27,2190736,147436.53,864,3534,0.76,0,0,0
1301,台塑         ,20141215,-80,-5.3,48353,3191.3,-2790,-184.14,2187977,144406.48,1092,3829,0.76,0,80,0
1301,台塑         ,20141216,-79,-5.25,48274,3205.39,-3301,-219.19,2183816,145005.38,2362,5678,0.76,0,79,0
1301,台塑         ,20141217,100,6.51,48374,3149.15,-5546,-361.04,2178259,141804.66,2395,7960,0.76,200,100,0
1301,台塑         ,20141218,0,0,48374,3192.68,-1298,-85.67,2176833,143670.98,2121,3428,0.76,0,0,0
1301,台塑         ,20141219,-46,-3.07,48328,3223.48,1548,103.25,2178414,145300.21,3102,1805,0.76,143,189,0
1301,台塑         ,20141222,0,0,48328,3286.3,1155,78.54,2178367,148128.96,1703,653,0.76,0,0,0
1301,台塑         ,20141223,198,13.6,48526,3333.74,674,46.3,2178283,149648.04,1304,900,0.76,198,0,0
1301,台塑         ,20141224,5195,372.48,53721,3851.8,5319,381.37,2183234,156537.88,1808,1219,0.84,5195,0,0.04
1301,台塑         ,20141225,1279,90.81,55000,3905,1885,133.84,2185119,155143.45,689,165,0.86,1279,0,0.01
1301,台塑         ,20141226,771,54.97,55771,3976.47,1780,126.91,2187027,155935.03,1313,244,0.88,771,0,0.01
1301,台塑         ,20141227,22,1.56,55793,3961.3,85,6.04,2187112,155284.95,0,0,0.88,22,0,0
1301,台塑         ,20141229,732,52.78,56525,4075.45,3819,275.35,2190931,157966.13,3751,724,0.89,740,8,0.01
1301,台塑         ,20141230,204,14.71,56729,4090.16,39,2.81,2191027,157973.05,1293,1365,0.89,587,383,0.01
1301,台塑         ,20141231,-712,-51.48,54539,3943.17,-879,-63.55,2189406,158294.05,1131,1236,0.86,90,802,0.01
1301,台塑         ,20150105,20,1.43,54559,3900.97,-1424,-101.82,2188029,156444.07,1259,2406,0.86,20,0,0
1301,台塑         ,20150106,288,19.87,54847,3784.44,-5638,-389.02,2183558,150665.5,1236,7024,0.86,288,0,0
1301,台塑         ,20150107,25,1.71,54872,3758.73,-3184,-218.1,2180030,149332.05,1573,4676,0.86,64,39,0
1301,台塑         ,20150108,2321,167.11,57193,4117.9,4809,346.25,2184615,157292.28,4601,2445,0.9,2321,0,0.02
1301,台塑         ,20150109,937,67.28,58130,4173.73,417,29.94,2184723,156863.11,891,1515,0.91,937,0,0.01
1301,台塑         ,20150112,2350,173.9,60480,4475.52,5986,442.96,2190983,162132.74,4809,1538,0.95,2350,0,0.02
1301,台塑         ,20150113,3492,260.15,63972,4765.91,4682,348.81,2196047,163605.5,3872,2395,1,3492,0,0.03
1301,台塑         ,20150114,225,16.47,64197,4699.22,-823,-60.24,2194218,160616.76,2243,3192,1.01,228,3,0
1301,台塑         ,20150115,546,40.4,64743,4790.98,1054,78,2195272,162450.13,2026,1521,1.02,546,0,0
1301,台塑         ,20150116,654,47.61,65397,4760.9,-1445,-105.2,2193837,159711.33,1403,3650,1.03,654,0,0.01
1301,台塑         ,20150119,1909,142.41,67306,5021.03,3377,251.92,2197214,163912.16,2758,1086,1.06,1909,0,0.01
1301,台塑         ,20150120,603,45.53,67909,5127.13,2921,220.54,2200256,166119.33,3358,1389,1.07,603,0,0
1301,台塑         ,20150121,123,9.35,68032,5170.43,4703,357.43,2204935,167575.06,6351,1626,1.07,123,0,0
1301,台塑         ,20150122,803,61.19,68835,5245.23,1246,94.95,2206357,168124.4,2404,1851,1.08,896,93,0.01
1301,台塑         ,20150123,603,46.07,69438,5305.06,3658,279.47,2208972,168765.46,4285,1213,1.09,608,5,0
1301,台塑         ,20150126,327,25.02,69765,5337.02,1015,77.65,2210250,169084.13,3976,3377,1.1,327,0,0
1301,台塑         ,20150127,0,0,69765,5337.02,2453,187.65,2212713,169272.54,3128,427,1.1,0,0,0
1301,台塑         ,20150128,180,13.86,69945,5385.77,1764,135.83,2214528,170518.66,2311,669,1.1,180,0,0
1301,台塑         ,20150129,-23,-1.78,69922,5397.98,1400,108.08,2216020,171076.74,4000,2379,1.1,33,56,0
1301,台塑         ,20150130,32,2.45,69954,5351.48,-1313,-100.44,2214319,169395.4,2626,3999,1.1,44,12,0
1301,台塑         ,20150202,113,8.73,70067,5416.18,2184,168.82,2217101,171381.91,3292,1133,1.1,113,0,0
1301,台塑         ,20150203,235,18.21,70302,5448.41,2460,190.65,2219473,172009.16,2977,887,1.1,235,0,0
1301,台塑         ,20150204,1122,88.08,71424,5606.78,6963,546.6,2226754,174800.19,7232,1475,1.12,1123,1,0.01
1301,台塑         ,20150205,16,1.25,71440,5572.32,3071,239.54,2229934,173934.85,3473,439,1.12,16,0,0
1301,台塑         ,20150206,-54,-4.23,71386,5589.52,4729,370.28,2234624,174971.06,5334,705,1.12,0,54,0
1301,台塑         ,20150209,1225,95.31,72611,5649.14,3869,301.01,2238032,174118.89,3637,958,1.14,1300,75,0.01
1301,台塑         ,20150210,350,27.09,72961,5647.18,1901,147.14,2239914,173369.34,2752,1172,1.15,350,0,0
1301,台塑         ,20150211,28,2.16,72989,5627.45,3012,232.23,2242930,172929.9,3821,1418,1.15,28,0,0
1301,台塑         ,20150212,-1341,-103.26,71648,5516.9,-48,-3.7,2242928,172705.46,3055,1686,1.13,0,1341,0.01
1301,台塑         ,20150213,-935,-71.71,70713,5423.69,1229,94.26,2244142,172125.69,3860,1889,1.11,0,935,0.01
1301,台塑         ,20150224,436,34.05,71149,5556.74,7210,563.1,2251458,175838.87,8076,1265,1.12,436,0,0
1301,台塑         ,20150225,-33,-2.57,71116,5539.94,3167,246.71,2255048,175668.24,4066,988,1.12,0,33,0
1301,台塑         ,20150226,460,35.65,71576,5547.14,1892,146.63,2255698,174816.6,6481,5110,1.12,867,407,0.01
1301,台塑         ,20150302,171,13.01,71747,5459.95,1592,121.15,2257065,171762.65,3215,2255,1.13,420,249,0.01
1301,台塑         ,20150303,-2,-0.15,71745,5452.62,1470,111.72,2258668,171658.77,2833,1399,1.13,0,2,0
1301,台塑         ,20150304,-139,-10.55,71606,5434.9,453,34.38,2259325,171482.77,2094,1137,1.12,3,142,0
1301,台塑         ,20150305,-678,-50.85,70928,5319.6,-113,-8.48,2259381,169453.58,1998,1236,1.11,371,1049,0.01
1301,台塑         ,20150306,-804,-61.26,70124,5343.45,187,14.25,2260053,172216.04,2685,2170,1.1,290,1094,0.01
1301,台塑         ,20150309,-43,-3.23,70081,5256.08,-1192,-89.4,2258840,169413,1449,2364,1.1,361,404,0.01
1301,台塑         ,20150310,-426,-31.61,69655,5168.4,-173,-12.84,2258457,167577.51,2801,2449,1.09,0,426,0
1301,台塑         ,20150311,-1,-0.07,69654,5119.57,-305,-22.42,2258584,166005.92,3183,2925,1.09,0,1,0
1301,台塑         ,20150312,0,-0.01,69654,5210.12,222,16.61,2258711,168951.58,2402,2274,1.09,0,0,0
1301,台塑         ,20150313,0,0,69654,5126.53,-2248,-165.45,2256655,166089.81,811,2912,1.09,0,0,0
1301,台塑         ,20150316,-14,-1.03,69640,5118.54,-548,-40.28,2256023,165817.69,1879,2497,1.09,0,14,0
1301,台塑         ,20150317,-73,-5.4,69567,5147.96,927,68.6,2256934,167013.12,2592,1574,1.09,0,73,0
1301,台塑         ,20150318,-964,-71.82,68603,5110.92,964,71.82,2258362,168247.97,4162,2333,1.08,0,964,0.01
1301,台塑         ,20150319,-262,-19.81,68341,5166.58,2497,188.77,2260913,170925.02,3194,529,1.07,0,262,0
1301,台塑         ,20150320,-36,-2.73,68305,5177.52,-543,-41.16,2260734,171363.64,3917,4701,1.07,3,39,0
1301,台塑         ,20150323,-44,-3.31,68261,5140.05,-764,-57.53,2260168,170190.65,468,1198,1.07,84,128,0
1301,台塑         ,20150324,-5,-0.38,68256,5166.98,151,11.43,2260250,171100.93,1564,1398,1.07,200,205,0
1301,台塑         ,20150325,-476,-35.22,67780,5015.72,-1830,-135.42,2258603,167136.62,490,1759,1.06,0,476,0
1301,台塑         ,20150326,-11,-0.83,67769,5089.45,863,64.81,2259859,169715.41,2650,1193,1.06,0,11,0
1301,台塑         ,20150327,607,45.46,68376,5121.36,-141,-10.56,2260064,169278.79,2148,2600,1.07,709,102,0.01
1301,台塑         ,20150330,52,3.89,68428,5125.26,462,34.6,2260401,169304.03,2249,1864,1.07,52,0,0
1301,台塑         ,20150331,15,1.14,64659,4907.62,815,61.86,2257444,171340,3000,2167,1.02,15,0,0
1301,台塑         ,20150401,36,2.68,64695,4819.78,-1254,-93.42,2255476,168032.96,2169,3435,1.02,36,0,0
1301,台塑         ,20150402,-109,-8.15,64586,4831.03,1608,120.28,2257121,168832.65,2905,1161,1.01,161,270,0
1301,台塑         ,20150407,0,0,64586,4882.7,335,25.33,2257425,170661.33,1422,1295,1.01,0,0,0
1301,台塑         ,20150408,1465,110.75,66051,4993.46,251,18.98,2257676,170680.31,2178,3529,1.04,1500,35,0.01
1301,台塑         ,20150409,0,0,66051,5019.88,-781,-59.36,2256895,171524.02,2310,3225,1.04,0,0,0
1301,台塑         ,20150410,180,13.77,66231,5066.67,1961,150.02,2258856,172802.48,2514,1210,1.04,180,0,0
1301,台塑         ,20150413,899,69.85,67130,5216,6701,520.67,2265612,176038.05,6458,1097,1.05,899,0,0.01
1301,台塑         ,20150414,-361,-28.12,66769,5201.31,1304,101.58,2266916,176592.76,6127,4367,1.05,33,394,0
1301,台塑         ,20150415,286,22.02,67055,5163.24,-1861,-143.3,2265065,174410.01,3849,6041,1.05,289,3,0
1301,台塑         ,20150416,0,0,67055,5230.29,5157,402.25,2270222,177077.32,5067,348,1.05,0,0,0
1301,台塑         ,20150417,1741,135.28,68796,5345.45,2578,200.31,2272826,176598.58,2421,1588,1.08,1741,0,0.01
1301,台塑         ,20150420,195,15.03,68991,5319.21,1132,87.28,2273984,175324.17,2016,1063,1.08,200,5,0
1301,台塑         ,20150421,180,14.13,69171,5429.92,5549,435.6,2279602,178948.76,5846,896,1.09,180,0,0
1301,台塑         ,20150422,226,17.76,69397,5454.6,2584,203.1,2282211,179381.78,7021,4535,1.09,226,0,0
1301,台塑         ,20150423,100,7.91,69497,5497.21,6533,516.76,2288571,181025.97,6999,818,1.09,100,0,0
1301,台塑         ,20150424,923,74.3,70420,5668.81,14141,1138.35,2302732,185369.93,12848,249,1.11,926,3,0.01
1301,台塑         ,20150427,190,15.35,70610,5705.29,5859,473.41,2308562,186531.81,6299,558,1.11,190,0,0
1301,台塑         ,20150428,-334,-26.99,70276,5678.3,3004,242.72,2311564,186774.37,5325,2115,1.1,150,484,0
1301,台塑         ,20150429,-8,-0.64,70268,5656.57,3785,304.69,2315333,186384.31,5263,1896,1.1,0,8,0
1301,台塑         ,20150430,298,23.51,70566,5567.66,426,33.61,2312497,182456.01,4882,4704,1.11,300,2,0
1301,台塑         ,20150504,29,2.32,70595,5640.54,880,70.31,2313617,184858,2845,1764,1.11,29,0,0
1301,台塑         ,20150505,-90,-7.23,70505,5661.55,1853,148.8,2315395,185926.22,2598,777,1.11,0,90,0
1301,台塑         ,20150506,208,16.64,70713,5657.04,1922,153.76,2317204,185376.32,3196,1529,1.11,493,285,0.01
1301,台塑         ,20150507,-510,-39.68,70203,5461.79,-2971,-231.14,2314199,180044.68,911,3406,1.1,8,518,0
1301,台塑         ,20150508,-162,-12.73,70041,5505.22,139,10.93,2314360,181908.7,1412,1096,1.1,0,162,0
1301,台塑         ,20150511,22,1.72,70063,5485.93,-359,-28.11,2314484,181224.1,1486,1395,1.1,22,0,0
1301,台塑         ,20150512,-70,-5.5,69993,5501.45,-64,-5.03,2314785,181942.1,1605,1166,1.1,0,70,0
1301,台塑         ,20150513,-79,-6.2,69914,5488.25,-865,-67.9,2313989,181648.14,473,1202,1.1,53,132,0
1301,台塑         ,20150514,-910,-70.71,69004,5361.61,-3575,-277.78,2296757,178458.02,1501,3833,1.08,3,913,0.01
1301,台塑         ,20150515,-131,-10.19,68873,5358.32,-1071,-83.32,2296106,178637.05,1500,2029,1.08,0,131,0
1301,台塑         ,20150518,0,0,68873,5406.53,-1021,-80.15,2295069,180162.92,1402,2328,1.08,0,0,0
1301,台塑         ,20150519,-429,-33.93,68444,5413.92,-352,-27.84,2294812,181519.63,3265,3168,1.08,0,429,0
1301,台塑         ,20150520,-807,-63.51,67637,5323.03,-1385,-109,2293636,180509.15,4266,4543,1.06,4,811,0.01
1301,台塑         ,20150521,-901,-67.67,66736,5011.87,-10541,-791.63,2283432,171485.74,718,10059,1.05,0,901,0.01
1301,台塑         ,20150522,-983,-76.08,65753,5089.28,752,58.2,2284301,176804.9,4992,3180,1.03,0,983,0.01
1301,台塑         ,20150525,-1094,-83.36,64659,4927.02,-2424,-184.71,2281940,173883.83,1466,2763,1.02,0,1094,0.01
1301,台塑         ,20150526,-239,-18.16,64420,4895.92,106,8.06,2282146,173443.1,1358,1007,1.01,0,239,0
1301,台塑         ,20150527,-405,-30.58,64015,4833.13,-320,-24.16,2281687,172267.37,3895,3812,1.01,0,405,0
1301,台塑         ,20150528,-2079,-156.13,61936,4651.39,-4112,-308.81,2277594,171047.31,2250,4274,0.97,12,2091,0.02
1301,台塑         ,20150529,-721,-54.29,61215,4609.49,-1010,-76.05,2276555,171424.59,5399,5717,0.96,0,721,0.01
1301,台塑         ,20150601,-345,-25.77,60870,4546.99,-408,-30.48,2276149,170028.33,2470,2531,0.96,0,345,0
1301,台塑         ,20150602,-33,-2.5,60837,4605.36,-599,-45.34,2275580,172261.41,2259,2795,0.96,0,33,0
1301,台塑         ,20150603,-110,-8.24,60727,4548.45,-2405,-180.13,2273115,170256.31,450,2703,0.95,0,110,0
1301,台塑         ,20150604,-924,-67.61,59803,4377.58,-4905,-359.05,2269402,166120.23,1634,5462,0.94,0,924,0.01
1301,台塑         ,20150605,-103,-7.48,59700,4334.22,-4181,-303.54,2266257,164530.26,845,3842,0.94,0,103,0
1301,台塑         ,20150608,-25,-1.85,59675,4404.02,-1986,-146.57,2264240,167100.91,919,2838,0.94,0,25,0
1301,台塑         ,20150609,-253,-18.47,59422,4337.81,-624,-45.55,2263392,165227.62,1357,1720,0.93,0,253,0
1301,台塑         ,20150610,354,26.09,59776,4405.49,-437,-32.21,2262539,166749.12,1241,2041,0.94,363,9,0
1301,台塑         ,20150611,-25,-1.85,59751,4415.6,-1694,-125.19,2260620,167059.82,2091,3721,0.94,60,85,0
1301,台塑         ,20150612,-949,-69.09,58802,4280.79,-2952,-214.91,2256057,164240.95,838,2813,0.92,0,949,0.01
1301,台塑         ,20150615,-51,-3.7,58751,4259.45,-942,-68.3,2251487,163232.81,950,1821,0.92,20,71,0
1301,台塑         ,20150616,-235,-16.92,58516,4213.15,-1613,-116.14,2249820,161987.04,1209,2585,0.92,0,235,0
1301,台塑         ,20150617,-18,-1.28,58498,4147.51,-3202,-227.02,2246685,159289.97,2583,5821,0.92,0,18,0
1301,台塑         ,20150618,-401,-28.87,58097,4182.98,-1153,-83.02,2245479,161674.49,4279,5099,0.91,0,401,0
1301,台塑         ,20150622,-37,-2.68,58060,4209.35,-780,-56.55,2243367,162644.11,1958,2880,0.91,1,38,0
1301,台塑         ,20150623,-131,-9.45,57929,4176.68,-1053,-75.92,2237515,161324.83,774,1905,0.91,91,222,0
1301,台塑         ,20150624,-245,-17.96,57684,4228.24,-174,-12.75,2230762,163514.85,1638,1531,0.91,10,255,0
1301,台塑         ,20150625,-289,-21.3,57395,4230.01,68,5.01,2225693,164033.57,3616,3360,0.9,10,299,0
1301,台塑         ,20150626,-94,-6.95,57301,4234.54,-9,-0.67,2219728,164037.9,2012,1943,0.9,0,94,0
1301,台塑         ,20150629,-471,-33.77,56830,4074.71,-2688,-192.73,2215059,158819.73,249,2502,0.89,2,473,0
1301,台塑         ,20150630,-200,-14.52,85860,6233.44,-179,-13,2244485,162949.61,3321,3273,1.35,0,200,0
1301,台塑         ,20150701,-2,-0.15,85858,6250.46,-216,-15.72,2243680,163339.9,2568,2812,1.35,0,2,0
1301,台塑         ,20150702,-700,-50.82,85158,6182.47,-1133,-82.26,2242547,162808.91,2000,2467,1.34,0,700,0.01
1301,台塑         ,20150703,-600,-43.5,84558,6130.46,-1653,-119.84,2240913,162466.19,932,1995,1.33,0,600,0
1301,台塑         ,20150706,-200,-14.44,84358,6090.65,-723,-52.2,2240200,161742.44,1293,1810,1.33,0,200,0
1301,台塑         ,20150707,-485,-34.92,83873,6038.86,39,2.81,2240250,161298,2801,2152,1.32,0,485,0
1301,台塑         ,20150708,0,0,83873,5871.11,-4735,-331.45,2235530,156487.1,1428,6014,1.32,0,0,0
1301,台塑         ,20150709,-9,-0.63,83864,5853.71,-2762,-192.79,2232748,155845.81,1474,4310,1.32,2,11,0
1301,台塑         ,20150713,-303,-21.21,83561,5849.27,-1769,-123.83,2234765,156433.55,1807,3246,1.31,25,328,0
1301,台塑         ,20150714,0,0,83561,5891.05,1863,131.34,2237508,157744.31,3235,1879,1.31,0,0,0
1301,台塑         ,20150715,-730,-52.78,82831,5988.68,2269,164.05,2236877,161726.21,5190,1827,1.3,31,761,0.01
1301,台塑         ,20150716,-167,-12.01,82664,5943.54,529,38.04,2237574,160881.57,2382,1647,1.3,245,412,0.01
1301,台塑         ,20150717,-140,-10.07,82524,5933.48,415,29.84,2237999,160912.13,1689,1136,1.3,112,252,0
1301,台塑         ,20150720,427,30.23,82951,5872.93,-294,-20.82,2237705,158429.51,1409,2130,1.3,427,0,0
1301,台塑         ,20150721,22,1.57,82973,5915.97,262,18.68,2237967,159567.05,801,546,1.3,22,0,0
1301,台塑         ,20150722,-159,-11.34,82814,5904.64,351,25.03,2238337,159593.43,1962,1522,1.3,30,189,0
1301,台塑         ,20150723,126,8.96,82940,5897.03,172,12.23,2238851,159182.31,1503,1596,1.3,126,0,0
1301,台塑         ,20150724,89,6.32,83029,5895.06,-135,-9.59,2239183,158981.99,944,1320,1.3,89,0,0
1301,台塑         ,20150727,0,0,83029,5803.73,-720,-50.33,2238475,156469.4,943,1862,1.3,0,0,0
1301,台塑         ,20150728,235,16.36,83264,5795.17,-744,-51.78,2238510,155800.3,3180,4546,1.31,235,0,0
1301,台塑         ,20150729,43,3.01,83307,5831.49,-714,-49.98,2239796,156785.72,2696,3437,1.31,43,0,0
1301,台塑         ,20150730,-4,-0.28,83303,5797.89,-621,-43.22,2240065,155908.52,2212,2832,1.31,40,44,0
1301,台塑         ,20150731,-11,-0.77,83292,5830.44,-1409,-98.63,2237668,156636.76,4074,5291,1.31,64,75,0
1301,台塑         ,20150803,256,17.87,83548,5831.65,-3,-0.21,2239942,156347.95,2707,2920,1.31,256,0,0
1301,台塑         ,20150804,42,2.92,83590,5809.51,124,8.62,2240448,155711.14,3428,4131,1.31,118,76,0
1301,台塑         ,20150805,238,16.9,83828,5951.79,2033,144.34,2242212,159197.05,3210,1666,1.32,238,0,0
1301,台塑         ,20150806,223,15.94,84051,6009.65,41,2.93,2241576,160272.68,1884,2118,1.32,223,0,0
1301,台塑         ,20150807,168,11.98,84219,6004.81,-174,-12.41,2241454,159815.67,1960,2211,1.32,168,0,0
1301,台塑         ,20150810,15,1.06,84234,5946.92,-1072,-75.68,2241048,158217.99,183,1261,1.32,19,4,0
1301,台塑         ,20150811,25,1.72,84259,5805.45,-3404,-234.54,2238210,154212.67,1904,4915,1.32,25,0,0
1301,台塑         ,20150812,-654,-44.93,83605,5743.66,-3414,-234.54,2234821,153532.2,1681,4691,1.31,106,760,0.01
1301,台塑         ,20150813,-838,-57.4,82767,5669.54,-1301,-89.12,2232852,152950.36,2815,3291,1.3,11,849,0.01
1301,台塑         ,20150814,0,0,82767,5669.54,-541,-37.06,2236840,153223.54,1018,1550,1.3,0,0,0
1301,台塑         ,20150817,3,0.21,82770,5669.75,-151,-10.34,2238846,153360.95,1313,1480,1.3,3,0,0
1301,台塑         ,20150818,-596,-40.47,82174,5579.61,-2617,-177.69,2236280,151843.41,3059,4870,1.29,66,662,0.01
1301,台塑         ,20150819,-11,-0.75,82163,5587.08,-941,-63.99,2235464,152011.55,2693,3522,1.29,2,13,0
1301,台塑         ,20150820,-151,-10.01,82012,5437.4,-4745,-314.59,2231535,147950.77,2032,6510,1.29,2,153,0
1301,台塑         ,20150821,470,31.02,82482,5443.81,-2530,-166.98,2229175,147125.55,1903,4850,1.3,470,0,0
1301,台塑         ,20150824,210,13.02,82692,5126.9,-4674,-289.79,2224877,137942.37,3037,8041,1.3,210,0,0
1301,台塑         ,20150825,345,21.94,83037,5281.15,-1248,-79.37,2224053,141449.77,3051,4638,1.3,345,0,0
1301,台塑         ,20150826,266,17.02,83303,5331.39,-2160,-138.24,2221375,142168,3031,5624,1.31,353,87,0
1301,台塑         ,20150827,-160,-10.4,83143,5404.3,-3228,-209.82,2218131,144178.52,2505,5452,1.31,1,161,0
1301,台塑         ,20150828,1,0.07,83144,5695.36,121,8.29,2218008,151933.55,3961,3546,1.31,1,0,0
1301,台塑         ,20150831,12,0.86,83156,5962.29,-412,-29.54,2218680,159079.36,7665,7687,1.31,62,50,0
1301,台塑         ,20150901,107,7.37,83263,5736.82,-1528,-105.28,2217818,152807.66,3334,4646,1.31,469,362,0.01
1301,台塑         ,20150902,311,21.43,83574,5758.25,-320,-22.05,2216945,152747.51,2649,3403,1.31,396,85,0
1301,台塑         ,20150903,-62,-4.23,83512,5703.87,-1073,-73.29,2214051,151219.68,1204,2079,1.31,124,186,0
1301,台塑         ,20150904,-37,-2.53,83475,5701.34,-1848,-126.22,2214634,151259.5,1141,2751,1.31,0,37,0
1301,台塑         ,20150907,293,20.04,83768,5729.73,-1252,-85.64,2213725,151418.79,736,2379,1.32,293,0,0
1301,台塑         ,20150908,-140,-9.52,83628,5686.7,-1663,-113.08,2212150,150426.2,713,2148,1.31,15,155,0
1301,台塑         ,20150909,-1020,-71.4,82608,5782.56,2832,198.24,2214770,155033.9,5794,2191,1.3,1,1021,0.01
1301,台塑         ,20150910,-24,-1.67,82584,5756.1,447,31.16,2215217,154400.62,1840,1301,1.3,110,134,0
1301,台塑         ,20150911,193,13.55,82777,5810.95,-31,-2.18,2214933,155488.3,737,1018,1.3,334,141,0
1301,台塑         ,20150914,90,6.34,82867,5833.84,-1133,-79.76,2214230,155881.79,1303,2074,1.3,115,25,0
1301,台塑         ,20150915,8,0.56,82875,5834.4,769,54.14,2215268,155954.87,2194,1371,1.3,8,0,0
1301,台塑         ,20150916,0,0,82875,5834.4,-1297,-91.31,2213872,155856.59,2223,3575,1.3,0,0,0
1301,台塑         ,20150917,732,52.63,83607,6011.34,1580,113.6,2215458,159291.43,4567,3816,1.31,732,0,0.01
1301,台塑         ,20150918,-393,-27.9,83214,5908.19,-754,-53.53,2214741,157246.61,3291,3615,1.31,10,403,0
1301,台塑         ,20150921,572,40.04,83786,5865.02,-2252,-157.64,2212867,154900.69,1756,4472,1.32,572,0,0
1301,台塑         ,20150922,91,6.4,83877,5921.72,-1053,-74.34,2211905,156160.49,1545,2710,1.32,542,451,0.01
1301,台塑         ,20150923,-41,-2.87,83836,5876.9,-4277,-299.82,2208728,154831.83,1102,5406,1.32,0,41,0
1301,台塑         ,20150924,-292,-20.15,83544,5764.54,-3127,-215.76,2205771,152198.2,619,3402,1.31,15,307,0
1301,台塑         ,20150925,161,11.01,83705,5725.42,-1655,-113.2,2204857,150812.22,1565,3464,1.31,161,0,0
1301,台塑         ,20150930,182,12.63,60265,4182.39,-81,-5.62,2180992,151360.84,6037,6415,0.95,330,148,0
1301,台塑         ,20151001,-103,-7.26,60162,4241.42,1603,113.01,2182189,153844.32,3855,2069,0.95,9,112,0
1301,台塑         ,20151002,53,3.75,60215,4263.22,1055,74.69,2183164,154568.01,2996,2054,0.95,53,0,0
1301,台塑         ,20151005,-31,-2.19,60184,4248.99,-40,-2.82,2183105,154127.21,1848,2039,0.95,0,31,0
1301,台塑         ,20151006,93,6.7,60277,4339.94,1257,90.5,2184507,157284.5,3626,3117,0.95,93,0,0
1301,台塑         ,20151007,792,59.32,61069,4574.07,4533,339.52,2189251,163974.9,4429,1548,0.96,792,0,0.01
1301,台塑         ,20151008,670,50.65,61739,4667.47,6676,504.71,2195365,165969.59,7105,874,0.97,670,0,0.01
1301,台塑         ,20151012,1186,92.39,62925,4901.86,7044,548.73,2202442,171570.23,7593,1835,0.99,1186,0,0.01
1301,台塑         ,20151013,736,56.82,63661,4914.63,2621,202.34,2205078,170232.02,4431,2384,1,736,0,0.01
1301,台塑         ,20151014,538,40.62,64199,4847.02,1776,134.09,2206864,166618.23,3695,2504,1.01,538,0,0
1301,台塑         ,20151015,70,5.33,64269,4890.87,5163,392.9,2211951,168329.47,5253,386,1.01,70,0,0
1301,台塑         ,20151016,111,8.37,64380,4854.25,2830,213.38,2214845,166999.31,3458,564,1.01,111,0,0
1301,台塑         ,20151019,458,35.27,64838,4992.53,5384,414.57,2220808,171002.22,5166,621,1.02,458,0,0
1301,台塑         ,20151020,378,29.03,65216,5008.59,1695,130.18,2222467,170685.47,3668,2241,1.02,378,0,0
1301,台塑         ,20151021,250,19.03,65466,4981.96,1250,95.13,2224724,169301.5,1650,636,1.03,250,0,0
1301,台塑         ,20151022,85,6.38,65551,4922.88,366,27.49,2225154,167109.07,2150,1307,1.03,85,0,0
1301,台塑         ,20151023,61,4.7,65612,5052.12,3859,297.14,2229480,171669.96,3952,210,1.03,135,74,0
1301,台塑         ,20151026,425,33.36,66037,5183.9,6470,507.9,2236177,175539.89,7548,1596,1.04,425,0,0
1301,台塑         ,20151027,15,1.18,66052,5185.08,1996,156.69,2238258,175703.25,3943,1767,1.04,15,0,0
1301,台塑         ,20151028,0,0,66052,5171.87,587,45.96,2238391,175266.02,2945,2119,1.04,0,0,0
1301,台塑         ,20151029,9,0.69,66061,5099.91,-1212,-93.57,2237276,172717.71,1721,2643,1.04,10,1,0
1301,台塑         ,20151030,12,0.91,66073,4988.51,1371,103.51,2237509,168931.93,4180,2976,1.04,12,0,0
1301,台塑         ,20151102,-64,-4.9,66009,5049.69,1027,78.57,2238536,171248,2187,1157,1.04,0,64,0
1301,台塑         ,20151103,76,5.92,66085,5148.02,3034,236.35,2241160,174586.36,3628,765,1.04,76,0,0
1301,台塑         ,20151104,141,11.1,66226,5211.99,4997,393.26,2246157,176772.56,7017,3080,1.04,144,3,0
1301,台塑         ,20151105,-71,-5.52,66155,5146.86,1246,96.94,2247403,174847.95,2534,1241,1.04,0,71,0
1301,台塑         ,20151106,6,0.45,66161,5008.39,-4542,-343.83,2242861,169784.58,1962,6793,1.04,81,75,0
1301,台塑         ,20151109,-56,-4.2,66105,4957.88,-503,-37.73,2242358,168176.85,1664,1676,1.04,45,101,0
1301,台塑         ,20151110,0,0,66105,4898.38,-1146,-84.92,2241212,166073.81,2789,3780,1.04,0,0,0
1301,台塑         ,20151111,381,28.65,66486,4999.75,-2047,-153.93,2239166,168385.28,2162,4801,1.04,415,34,0
1301,台塑         ,20151112,144,10.89,66630,5037.23,925,69.93,2240113,169352.54,2805,2009,1.05,144,0,0
1301,台塑         ,20151113,140,10.26,66770,4894.24,-2130,-156.13,2237759,164027.73,1325,3432,1.05,142,2,0
1301,台塑         ,20151116,44,3.21,66814,4870.74,-1460,-106.43,2236142,163014.75,1925,3468,1.05,44,0,0
1301,台塑         ,20151117,67,4.96,66881,4949.19,2535,187.59,2238318,165635.53,3351,923,1.05,100,33,0
1301,台塑         ,20151118,-99,-7.23,66782,4875.09,-223,-16.28,2238095,163380.94,3146,3068,1.05,101,200,0
1301,台塑         ,20151119,11,0.83,66793,5016.15,1814,136.23,2239909,168217.17,3384,1550,1.05,70,59,0
1301,台塑         ,20151120,-33,-2.47,66760,5000.32,740,55.43,2240659,167825.36,2454,1661,1.05,0,33,0
1301,台塑         ,20151123,-172,-13.07,66588,5060.69,2804,213.1,2243532,170508.43,4602,1635,1.05,0,172,0
1301,台塑         ,20151124,107,8.03,66695,5002.13,912,68.4,2244486,168336.45,2304,1502,1.05,122,15,0
1301,台塑         ,20151125,100,7.55,66795,5043.02,1138,85.92,2245651,169546.65,2480,1411,1.05,100,0,0
1301,台塑         ,20151126,30,2.3,66825,5112.11,1715,131.2,2247421,171927.71,3892,1932,1.05,30,0,0
1301,台塑         ,20151127,-114,-8.54,66711,4996.65,-860,-64.41,2246418,168256.71,1922,2597,1.05,0,114,0
1301,台塑         ,20151130,-119,-8.77,66592,4907.83,-3934,-289.94,2242336,165260.16,12095,15827,1.05,126,245,0
1301,台塑         ,20151201,-200,-15.12,66392,5019.24,4822,364.54,2247288,169894.97,6306,1154,1.04,0,200,0
1301,台塑         ,20151202,-142,-10.69,66250,4988.63,564,42.47,2248062,169279.07,2924,2156,1.04,17,159,0
1301,台塑         ,20151203,-439,-33.28,65811,4988.47,2255,170.93,2250241,170568.27,4914,2168,1.03,99,538,0.01
1301,台塑         ,20151204,0,0,65811,4922.66,-2271,-169.87,2248031,168152.72,1966,4242,1.03,0,0,0
1301,台塑         ,20151207,219,16.32,66030,4919.24,2989,222.68,2251175,167712.54,4017,1160,1.04,219,0,0
1301,台塑         ,20151208,15,1.09,66045,4814.68,-390,-28.43,2250834,164085.8,3608,3973,1.04,15,0,0
1301,台塑         ,20151209,-630,-45.93,65415,4768.75,-1363,-99.36,2249457,163985.42,2592,3339,1.03,0,630,0
1301,台塑         ,20151210,-300,-21.66,65115,4701.3,-1900,-137.18,2247904,162298.67,5949,7617,1.02,0,300,0
1301,台塑         ,20151211,0,0,65115,4688.28,-2442,-175.82,2245592,161682.62,3383,5800,1.02,0,0,0
1301,台塑         ,20151214,-2,-0.18,65113,4642.56,-1104,-78.72,2244666,160044.69,2106,3072,1.02,0,2,0
1301,台塑         ,20151215,-735,-51.82,64378,4538.65,263,18.54,2245199,158286.53,4086,3266,1.01,15,750,0.01
1301,台塑         ,20151216,-3,-0.21,64375,4577.06,1955,139,2246897,159754.38,3002,1341,1.01,0,3,0
1301,台塑         ,20151217,0,0,64375,4686.5,3209,233.62,2250150,163810.92,5595,2321,1.01,0,0,0
1301,台塑         ,20151218,-21,-1.53,64354,4684.97,2879,209.59,2253496,164054.51,7445,4463,1.01,0,21,0
1301,台塑         ,20151221,0,0,64354,4659.23,-490,-35.48,2252940,163112.86,2463,2907,1.01,0,0,0
1301,台塑         ,20151222,-239,-17.45,64115,4680.4,-1075,-78.48,2251005,164323.37,1554,2279,1.01,28,267,0
1301,台塑         ,20151223,51,3.71,64166,4671.28,896,65.23,2251907,163938.83,1609,776,1.01,279,228,0
1301,台塑         ,20151224,-742,-54.46,63424,4655.32,735,53.95,2252574,165338.93,1985,586,1,300,1042,0.01
1301,台塑         ,20151225,-179,-13.08,63245,4623.21,434,31.73,2253081,164700.22,1246,586,0.99,175,354,0
1301,台塑         ,20151228,170,12.58,63415,4692.71,1909,141.27,2254985,166868.89,2502,791,1,170,0,0
1301,台塑         ,20151229,95,6.93,63510,4629.88,-1246,-90.83,2253055,164247.71,1332,2583,1,236,141,0
1301,台塑         ,20151230,135,9.92,63645,4677.91,-1254,-92.17,2252021,165523.54,891,2137,1,135,0,0
1301,台塑         ,20151231,-3100,-238.7,60497,4658.27,-4307,-331.64,2249057,173177.39,1801,2698,0.95,0,3100,0.02
1301,台塑         ,20160104,1159,83.91,61656,4463.89,-4883,-353.53,2244368,162492.24,680,6850,0.97,1159,0,0.01
1301,台塑         ,20160105,-1180,-86.02,60476,4408.7,-612,-44.61,2243766,163570.54,2623,2031,0.95,0,1180,0.01
1301,台塑         ,20160106,-748,-54.6,59728,4360.14,-2177,-158.92,2241603,163637.02,2394,3822,0.94,108,856,0.01
1301,台塑         ,20160107,102,7.45,59830,4367.59,-6576,-480.05,2234599,163125.73,3157,9901,0.94,106,4,0
1301,台塑         ,20160108,0,0,59830,4271.86,-3364,-240.19,2230876,159284.55,900,4274,0.94,0,0,0
1301,台塑         ,20160111,753,53.99,60583,4343.8,-3331,-238.83,2227545,159714.98,1705,5824,0.95,1252,499,0.01
1301,台塑         ,20160112,27,1.97,60610,4418.47,-299,-21.8,2226611,162319.94,3186,3461,0.95,29,2,0
1301,台塑         ,20160113,150,11.24,60760,4550.92,6138,459.74,2232549,167217.92,9297,3340,0.95,151,1,0
1301,台塑         ,20160114,0,0,60760,4569.15,1780,133.86,2234424,168028.68,6009,4101,0.95,0,0,0
1301,台塑         ,20160115,-11,-0.83,60749,4586.55,-2536,-191.47,2231952,168512.38,4011,6371,0.95,28,39,0
1301,台塑         ,20160118,-1030,-77.77,59719,4508.78,-12,-0.91,2232000,168516,5413,4340,0.94,31,1061,0.01
1301,台塑         ,20160119,-538,-40.62,59181,4468.17,1558,117.63,2231304,168463.45,3732,1754,0.93,100,638,0.01
1301,台塑         ,20160120,-449,-34.12,58732,4463.63,2758,209.61,2234400,169814.4,7493,4143,0.92,0,449,0
1301,台塑         ,20160121,-196,-14.48,58536,4325.81,-1466,-108.34,2233207,165034,2224,3488,0.92,0,196,0
1301,台塑         ,20160122,0,0,58536,4355.08,1326,98.65,2234871,166274.4,2935,1599,0.92,0,0,0
1301,台塑         ,20160125,15,1.14,58551,4449.88,828,62.93,2235667,169910.69,2514,1733,0.92,20,5,0
1301,台塑         ,20160126,0,0,58551,4414.75,-850,-64.09,2234864,168508.75,1840,2643,0.92,0,0,0
1301,台塑         ,20160127,0,0,58551,4385.47,766,57.37,2234874,167392.06,1588,859,0.92,0,0,0
1301,台塑         ,20160128,0,0,58551,4426.46,2165,163.67,2236632,169089.38,4182,2196,0.92,0,0,0
1301,台塑         ,20160129,2,0.15,58553,4508.58,4349,334.87,2241005,172557.39,6789,2446,0.92,2,0,0
1301,台塑         ,20160130,147,11.25,58700,4490.55,1017,77.8,2241940,171508.41,833,0,0.92,147,0,0
1301,台塑         ,20160201,0,0,58700,4472.94,2180,166.12,2244274,171013.68,2746,604,0.92,0,0,0
1301,台塑         ,20160202,534,40.85,59234,4531.4,4060,310.59,2248302,171995.1,5075,1509,0.93,534,0,0
1301,台塑         ,20160203,0,0,59234,4460.32,634,47.74,2249247,169368.3,3599,2989,0.93,0,0,0
1301,台塑         ,20160215,69,5.23,59303,4495.17,-289,-21.91,2248968,170471.77,3839,4212,0.93,70,1,0
1301,台塑         ,20160216,23,1.76,59326,4532.51,2244,171.44,2251391,172006.27,3232,1176,0.93,23,0,0
1301,台塑         ,20160217,1,0.08,59327,4556.31,2099,161.2,2253490,173068.03,2407,538,0.93,1,0,0
1301,台塑         ,20160218,0,0,59327,4609.71,1903,147.86,2255572,175257.94,4308,2507,0.93,0,0,0
1301,台塑         ,20160219,-1,-0.08,59326,4633.36,3239,252.97,2258812,176413.22,4224,991,0.93,0,1,0
1301,台塑         ,20160222,0,0,59326,4615.56,250,19.45,2259151,175761.95,2039,1800,0.93,0,0,0
1301,台塑         ,20160223,0,0,59326,4591.83,900,69.66,2260288,174946.29,1689,762,0.93,0,0,0
1301,台塑         ,20160224,0,0,59326,4568.1,670,51.59,2260840,174084.68,1940,1189,0.93,0,0,0
1301,台塑         ,20160225,0,0,59326,4639.29,3020,236.16,2264088,177051.68,3382,360,0.93,0,0,0
1301,台塑         ,20160226,1093,86.35,60419,4773.1,4598,363.24,2268683,179225.96,6636,3130,0.95,1093,0,0.01
1301,台塑         ,20160301,0,0,60419,4803.31,2351,186.9,2271235,180563.18,6301,3965,0.95,0,0,0
1301,台塑         ,20160302,-28,-2.21,60391,4831.28,2682,214.56,2274144,181931.52,4521,2061,0.95,0,28,0
1301,台塑         ,20160303,120,9.6,60511,4840.88,3882,310.56,2278191,182255.28,5736,1882,0.95,120,0,0
1301,台塑         ,20160304,200,16,60711,4856.88,2220,177.6,2280627,182450.16,4163,2214,0.95,200,0,0
1301,台塑         ,20160307,323,25.84,61034,4882.72,3001,240.08,2283628,182690.24,4892,3164,0.96,323,0,0
1301,台塑         ,20160308,-63,-5.04,60971,4877.68,6863,549.04,2290490,183239.2,8360,1242,0.96,27,90,0
1301,台塑         ,20160309,-834,-65.39,60137,4714.74,3047,238.88,2293716,179827.33,4754,1175,0.94,92,926,0.01
1301,台塑         ,20160310,-31,-2.45,60106,4748.37,4016,317.26,2297733,181520.91,5985,1886,0.94,0,31,0
1301,台塑         ,20160311,-179,-14.14,59927,4734.23,3427,270.73,2301013,181780.03,4103,515,0.94,0,179,0
1301,台塑         ,20160314,-45,-3.55,59882,4718.7,1973,155.47,2302986,181475.3,2844,826,0.94,0,45,0
1301,台塑         ,20160315,-71,-5.57,59811,4695.16,2200,172.7,2305377,180972.09,3327,990,0.94,0,71,0
1301,台塑         ,20160316,-659,-51.34,59152,4607.94,1497,116.62,2306834,179702.37,3312,1111,0.93,0,659,0.01
1301,台塑         ,20160317,-27,-2.13,59125,4670.88,5116,404.16,2312269,182669.25,6345,989,0.93,0,27,0
1301,台塑         ,20160318,-23,-1.85,59102,4757.71,6235,501.92,2319053,186683.77,12226,5951,0.93,77,100,0
1301,台塑         ,20160321,-73,-5.83,59029,4716.42,897,71.67,2319950,185364.01,3604,2711,0.93,0,73,0
1301,台塑         ,20160322,0,0,59029,4698.71,-89,-7.08,2320412,184704.8,4466,4551,0.93,0,0,0
1301,台塑         ,20160323,0,0,59029,4716.42,1531,122.33,2321943,185523.25,3174,1607,0.93,0,0,0
1301,台塑         ,20160324,-45,-3.61,58984,4730.52,3320,266.26,2326172,186558.99,4010,750,0.93,36,81,0
1301,台塑         ,20160325,-67,-5.31,58917,4666.23,-135,-10.69,2326046,184222.84,507,455,0.93,0,67,0
1301,台塑         ,20160328,90,7.2,59007,4720.56,2965,237.2,2329572,186365.76,3275,449,0.93,90,0,0
1301,台塑         ,20160329,27,2.15,59034,4699.11,1263,100.53,2330850,185535.66,3554,2138,0.93,28,1,0
1301,台塑         ,20160330,-44,-3.56,58990,4766.39,5556,448.92,2336225,188766.98,9328,3650,0.93,0,44,0
1301,台塑         ,20160331,-9,-0.72,57030,4550.99,1159,92.49,2334850,186321.03,7081,5975,0.9,80,89,0
1301,台塑         ,20160401,0,0,57030,4533.89,323,25.68,2335983,185710.65,5755,5221,0.9,0,0,0
1301,台塑         ,20160406,-476,-36.99,56554,4394.25,-155,-12.04,2336002,181507.36,5807,5312,0.89,0,476,0
1301,台塑         ,20160407,-54,-4.23,56500,4423.95,453,35.47,2336287,182931.27,3428,2899,0.89,0,54,0
1301,台塑         ,20160408,-210,-16.57,56290,4441.28,912,71.96,2337968,184465.68,4847,3419,0.88,0,210,0
1301,台塑         ,20160411,0,0,56290,4446.91,618,48.82,2338591,184748.69,2054,1431,0.88,0,0,0
1301,台塑         ,20160412,1,0.08,56291,4475.13,1958,155.66,2340449,186065.7,3092,1072,0.88,1,0,0
1301,台塑         ,20160413,-48,-3.87,56243,4538.81,7551,609.37,2347869,189473.03,8017,548,0.88,0,48,0
1301,台塑         ,20160414,0,0,56243,4578.18,3008,244.85,2350902,191363.42,5052,2020,0.88,0,0,0
1301,台塑         ,20160415,-89,-7.3,56154,4604.63,3768,308.98,2354442,193064.24,4359,730,0.88,14,103,0
1301,台塑         ,20160418,14,1.14,56168,4560.84,1671,135.69,2356116,191316.62,2044,384,0.88,14,0,0
1301,台塑         ,20160419,90,7.34,56258,4590.65,5266,429.71,2361308,192682.73,6627,1525,0.88,150,60,0
1301,台塑         ,20160420,301,24.32,56559,4569.97,2754,222.52,2364203,191027.6,5064,2565,0.89,302,1,0
1301,台塑         ,20160421,-232,-18.61,56327,4517.43,1369,109.79,2365151,189685.11,2730,1655,0.88,39,271,0
1301,台塑         ,20160422,42,3.4,56369,4565.89,3204,259.52,2368594,191856.11,3254,737,0.89,42,0,0
1301,台塑         ,20160425,-14,-1.15,56355,4615.47,4787,392.06,2373381,194379.9,6081,1341,0.89,0,14,0
1301,台塑         ,20160426,0,0,56355,4553.48,2680,216.54,2375822,191966.42,4954,2644,0.89,0,0,0
1301,台塑         ,20160427,0,0,56355,4604.2,2413,197.14,2378235,194301.8,5527,3091,0.89,0,0,0
1301,台塑         ,20160428,0,0,56355,4592.93,1227,100,2379461,193926.07,7133,5040,0.89,0,0,0
1301,台塑         ,20160429,10,0.8,56365,4526.11,-773,-62.07,2378716,191010.89,4489,4964,0.89,15,5,0
1301,台塑         ,20160503,0,0,56365,4452.84,-1024,-80.9,2377783,187844.86,2842,3774,0.89,0,0,0
1301,台塑         ,20160504,-20,-1.55,56345,4372.37,-2038,-158.15,2375845,184365.57,5080,6988,0.89,0,20,0
1301,台塑         ,20160505,815,62.92,57160,4412.75,-457,-35.28,2375242,183368.68,2378,3807,0.9,965,150,0.01
1301,台塑         ,20160506,0,0,57160,4447.05,-1344,-104.56,2373614,184667.17,3177,4601,0.9,0,0,0
1301,台塑         ,20160509,0,0,57160,4435.62,-988,-76.67,2372386,184097.15,2423,3433,0.9,0,0,0
1301,台塑         ,20160510,160,12.33,57320,4419.37,-210,-16.19,2371809,182866.47,3149,3535,0.9,160,0,0
1301,台塑         ,20160511,0,0,57320,4413.64,-2252,-173.4,2369557,182455.89,2389,4977,0.9,0,0,0
1301,台塑         ,20160512,0,0,57320,4419.37,-35,-2.7,2369403,182680.97,2670,2671,0.9,0,0,0
1301,台塑         ,20160513,-45,-3.44,57275,4381.54,-2051,-156.9,2367352,181102.43,4188,5965,0.9,0,45,0
1301,台塑         ,20160516,-12,-0.93,57263,4420.7,-790,-60.99,2366386,182685,3640,4209,0.9,0,12,0
1301,台塑         ,20160517,-133,-10.25,57130,4404.72,-1978,-152.5,2364069,182269.72,2076,4183,0.9,70,203,0
1301,台塑         ,20160518,-1423,-110.57,55707,4328.43,-347,-26.96,2363843,183670.6,3696,2679,0.88,0,1423,0.01
1301,台塑         ,20160519,-1488,-112.94,54219,4115.22,-4369,-331.61,2359474,179084.08,2468,5168,0.85,0,1488,0.01
1301,台塑         ,20160520,0,0,54219,4136.91,1202,91.71,2381329,181695.4,3328,2292,0.85,0,0,0
1301,台塑         ,20160523,-17,-1.31,54202,4173.55,1029,79.23,2382358,183441.57,3318,2149,0.85,0,17,0
1301,台塑         ,20160524,0,0,54202,4244.02,1887,147.75,2384153,186679.18,3173,1135,0.85,0,0,0
1301,台塑         ,20160525,0,0,54202,4281.96,609,48.11,2384853,188403.39,3279,2579,0.85,0,0,0
1301,台塑         ,20160526,-2,-0.16,54200,4233.02,-335,-26.16,2384523,186231.25,2060,2388,0.85,0,2,0
1301,台塑         ,20160527,-15,-1.18,54185,4248.1,285,22.34,2384808,186968.95,2203,1903,0.85,0,15,0
1301,台塑         ,20160530,-13,-1.03,54172,4285.01,1798,142.22,2386759,188792.64,3382,1440,0.85,2,15,0
1301,台塑         ,20160531,-1201,-94.88,52971,4184.71,-1064,-84.06,2385834,188480.89,9711,9314,0.83,0,1201,0.01
1301,台塑         ,20160601,-224,-17.7,52747,4167.01,2174,171.75,2387768,188633.67,3394,1004,0.83,4,228,0
1301,台塑         ,20160602,-134,-10.57,52613,4151.17,1048,82.69,2388567,188457.94,2499,1307,0.83,0,134,0
1301,台塑         ,20160603,-93,-7.35,52520,4149.08,722,57.04,2388679,188705.64,2671,1857,0.83,0,93,0
1301,台塑         ,20160604,-186,-14.66,52334,4123.92,-90,-7.09,2388337,188200.96,96,0,0.82,0,186,0
1301,台塑         ,20160606,-38,-2.98,52296,4105.24,-353,-27.71,2388018,187459.41,2400,2681,0.82,0,38,0
1301,台塑         ,20160607,-12,-0.96,52284,4177.49,4400,351.56,2391893,191112.25,5583,1533,0.82,0,12,0
1301,台塑         ,20160608,-125,-10.16,52159,4240.53,6138,499.02,2398284,194980.49,8270,1457,0.82,0,125,0
1301,台塑         ,20160613,-230,-18.17,51929,4102.39,-827,-65.33,2397114,189372.01,3137,3826,0.82,0,230,0
1301,台塑         ,20160614,-563,-44.25,51366,4037.37,-672,-52.82,2396112,188334.4,2717,2857,0.81,0,563,0
1301,台塑         ,20160615,-443,-34.83,50923,4007.64,1882,148.11,2397785,188705.68,3559,1308,0.8,0,443,0
1301,台塑         ,20160616,-555,-42.74,50368,3878.34,-2270,-174.79,2395127,184424.78,1690,3410,0.79,0,555,0
1301,台塑         ,20160617,-1057,-81.07,49311,3782.15,948,72.71,2395622,183744.21,4080,2456,0.77,1,1058,0.01
1301,台塑         ,20160620,-20,-1.55,49291,3820.05,2339,181.27,2397961,185841.98,2906,1006,0.77,0,20,0
1301,台塑         ,20160621,0,0,49291,3854.56,2235,174.78,2402869,187904.36,3044,1413,0.77,0,0,0
1301,台塑         ,20160622,-60,-4.7,49231,3859.71,864,67.74,2403362,188423.58,2754,1888,0.77,0,60,0
1301,台塑         ,20160623,-40,-3.08,49191,3792.63,-2136,-164.69,2400973,185115.02,1256,3663,0.77,0,40,0
1301,台塑         ,20160624,-185,-14,49006,3709.75,-4711,-356.62,2396262,181397.03,3130,7401,0.77,23,208,0
1301,台塑         ,20160627,-421,-32.08,48585,3702.18,-1820,-138.68,2394442,182456.48,1174,2563,0.76,0,421,0
1301,台塑         ,20160628,120,9.12,48705,3701.58,-3469,-263.64,2390973,181713.95,2230,6083,0.77,120,0,0
1301,台塑         ,20160629,0,0,48705,3745.41,-64,-4.92,2390909,183860.9,2444,2326,0.77,0,0,0
1301,台塑         ,20160630,50,3.89,50503,3929.13,119,9.26,2391498,186058.54,5380,5199,0.79,50,0,0
1301,台塑         ,20160701,-245,-19.31,50258,3960.33,670,52.8,2392168,188502.84,5428,5046,0.79,0,245,0
1301,台塑         ,20160704,360,28.37,50618,3988.7,127,10.01,2392295,188512.85,1748,2184,0.8,414,54,0
1301,台塑         ,20160705,-116,-9.14,50502,3979.56,-166,-13.08,2392130,188499.84,1577,1648,0.79,0,116,0
1301,台塑         ,20160706,-261,-20.23,50241,3893.68,-4173,-323.41,2387957,185066.67,1518,5373,0.79,146,407,0
1301,台塑         ,20160707,19,1.48,50260,3925.31,402,31.4,2388369,186531.62,810,450,0.79,19,0,0
1301,台塑         ,20160711,29,2.3,50289,3992.95,2235,177.46,2390603,189813.88,4216,2529,0.79,29,0,0
1301,台塑         ,20160712,480,38.69,50769,4091.98,2952,237.93,2393545,192919.73,4378,4423,0.8,480,0,0
1301,台塑         ,20160713,0,0,50769,3959.98,-2257,-176.05,2391300,186521.4,3902,3267,0.8,0,0,0
1301,台塑         ,20160714,-255,-19.86,50514,3935.04,969,75.49,2392306,186360.64,3625,2170,0.79,0,255,0
1301,台塑         ,20160715,20,1.57,50534,3961.87,1715,134.46,2394118,187698.85,4884,2924,0.79,20,0,0
1301,台塑         ,20160718,42,3.33,50576,4005.62,4171,330.34,2399849,190068.04,5327,926,0.79,42,0,0
1301,台塑         ,20160719,-3,-0.24,50573,4035.73,4013,320.24,2403924,191833.14,6632,2664,0.79,9,12,0
1301,台塑         ,20160720,-76,-6.07,50497,4034.71,3908,312.25,2409261,192499.95,5618,1494,0.79,188,264,0
1301,台塑         ,20160721,-141,-11.25,50356,4018.41,4623,368.92,2414964,192714.13,5875,1296,0.79,1,142,0
1301,台塑         ,20160722,23,1.84,50379,4030.32,2368,189.44,2420671,193653.68,3722,1387,0.79,71,48,0
1301,台塑         ,20160725,149,11.92,50528,4042.24,3444,275.52,2425286,194022.88,5255,2060,0.79,219,70,0
1301,台塑         ,20160726,37,2.96,50565,4040.14,2355,188.16,2431612,194285.8,4247,1865,0.79,150,113,0
1301,台塑         ,20160727,-307,-24.25,50258,3970.38,-172,-13.59,2431501,192088.58,3007,3049,0.79,0,307,0
1301,台塑         ,20160728,-47,-3.71,50211,3961.65,1343,105.96,2432926,191957.86,5447,4184,0.79,0,47,0
1301,台塑         ,20160729,-202,-15.71,50009,3890.7,-117,-9.1,2431182,189145.96,4546,4231,0.79,1,203,0
1301,台塑         ,20160801,10,0.78,50019,3911.49,-215,-16.81,2430120,190035.38,3791,4128,0.79,10,0,0
1301,台塑         ,20160802,233,17.96,50252,3874.43,-2038,-157.13,2427244,187140.51,1330,3605,0.79,292,59,0
1301,台塑         ,20160803,-73,-5.66,50179,3893.89,354,27.47,2427598,188381.6,3479,2969,0.79,30,103,0
1301,台塑         ,20160804,185,14.32,50364,3898.17,-1586,-122.76,2426263,187792.76,1340,2911,0.79,227,42,0
1301,台塑         ,20160805,191,15.01,50555,3973.62,1004,78.91,2427395,190793.25,7685,6815,0.79,200,9,0
1301,台塑         ,20160808,157,12.34,50712,3985.96,-1030,-80.96,2426458,190719.6,3251,4432,0.8,201,44,0
1301,台塑         ,20160809,-300,-23.64,50412,3972.47,-317,-24.98,2426263,191189.52,4039,4006,0.79,1,301,0
1301,台塑         ,20160810,5,0.4,50417,4013.19,-278,-22.13,2425937,193104.59,4491,4898,0.79,5,0,0
1301,台塑         ,20160811,-79,-6.32,50338,4027.04,-270,-21.6,2425537,194042.96,5567,5587,0.79,1,80,0
1301,台塑         ,20160812,-5,-0.4,50333,4026.64,13,1.04,2425471,194037.68,4835,4989,0.79,0,5,0
1301,台塑         ,20160815,-27,-2.16,50306,4024.48,180,14.4,2425712,194056.96,1921,1702,0.79,0,27,0
1301,台塑         ,20160816,1,0.08,50307,4014.5,-531,-42.37,2425257,193535.51,2713,3186,0.79,10,9,0
1301,台塑         ,20160817,1,0.08,50308,3999.49,1226,97.47,2426592,192914.06,2535,1212,0.79,1,0,0
1301,台塑         ,20160818,-3,-0.24,50305,4019.37,720,57.53,2427301,193941.35,1896,1183,0.79,0,3,0
1301,台塑         ,20160819,-143,-11.17,50162,3917.65,-1548,-120.9,2425755,189451.47,959,2373,0.79,1,144,0
1301,台塑         ,20160822,-7,-0.55,50155,3917.11,-683,-53.34,2425117,189401.64,1760,2378,0.79,2,9,0
1301,台塑         ,20160823,-1,-0.08,50154,3977.21,573,45.44,2425997,192381.56,2211,1740,0.79,0,1,0
1301,台塑         ,20160824,-7,-0.55,50147,3951.58,-29,-2.29,2425651,191141.3,889,890,0.79,0,7,0
1301,台塑         ,20160825,4,0.32,50151,3961.93,428,33.81,2426225,191671.78,1839,1279,0.79,6,2,0
1301,台塑         ,20160826,-88,-6.97,50063,3964.99,299,23.68,2426483,192177.45,1106,771,0.79,0,88,0
1301,台塑         ,20160829,-1,-0.08,50062,3984.94,-25,-1.99,2426749,193169.22,1465,1335,0.79,0,1,0
1301,台塑         ,20160830,33,2.62,50095,3972.53,-693,-54.95,2426008,192382.43,1454,2227,0.79,34,1,0
1301,台塑         ,20160831,-19,-1.49,50076,3920.95,-2315,-181.26,2423334,189747.05,2874,5124,0.79,1,20,0
1301,台塑         ,20160901,102,7.85,50178,3863.71,-3624,-279.05,2419923,186334.07,1496,5009,0.79,102,0,0
1301,台塑         ,20160902,-97,-7.57,50081,3906.32,123,9.59,2420074,188765.77,1321,1138,0.79,0,97,0
1301,台塑         ,20160905,-2,-0.16,50079,3941.22,431,33.92,2420719,190510.59,1520,1129,0.79,0,2,0
1301,台塑         ,20160906,0,0,50079,3991.3,1693,134.93,2422560,193078.03,3344,1687,0.79,0,0,0
1301,台塑         ,20160907,99,7.93,50178,4019.26,1084,86.83,2423913,194155.43,2051,1469,0.79,169,70,0
1301,台塑         ,20160908,-7,-0.56,50171,3993.61,-314,-24.99,2423987,192949.37,1796,2122,0.79,0,7,0
1301,台塑         ,20160909,1,0.08,50172,3908.4,-4823,-375.71,2419164,188452.88,611,5511,0.79,1,0,0
1301,台塑         ,20160910,0,0,50172,3888.33,-1290,-99.98,2417878,187385.55,0,1023,0.79,0,0,0
1301,台塑         ,20160912,0,0,50172,3843.18,-5135,-393.34,2412888,184827.22,405,5353,0.79,0,0,0
1301,台塑         ,20160913,1,0.08,50173,3838.23,-3990,-305.24,2408967,184285.98,2257,6349,0.79,1,0,0
1301,台塑         ,20160914,66,5.01,50239,3813.14,-3307,-251,2405660,182589.59,3939,7272,0.79,66,0,0
1301,台塑         ,20160919,100,7.74,50339,3896.24,666,51.55,2406326,186249.63,1744,1235,0.79,100,0,0
1301,台塑         ,20160920,0,0,50339,3891.2,18,1.39,2406435,186017.43,1235,1217,0.79,0,0,0
1301,台塑         ,20160921,-5,-0.39,50334,3931.09,589,46,2407025,187988.65,2438,1859,0.79,0,5,0
1301,台塑         ,20160922,0,0,50334,3941.15,641,50.19,2407701,188522.99,1422,768,0.79,0,0,0
1301,台塑         ,20160923,-29,-2.28,50305,3959,1245,97.98,2408971,189586.02,3184,2010,0.79,0,29,0
1301,台塑         ,20160926,140,10.98,50445,3954.89,-153,-12,2408828,188852.12,730,1017,0.79,150,10,0
1301,台塑         ,20160929,125,9.84,50570,3979.86,1697,133.55,2410540,189709.5,4985,3436,0.79,125,0,0
1301,台塑         ,20160930,330,25.65,37402,2909.88,-1754,-136.46,2397530,186527.83,2651,4713,0.59,330,0,0
1301,台塑         ,20161003,150,11.73,37552,2936.57,287,22.44,2397851,187511.95,1390,1219,0.59,150,0,0
1301,台塑         ,20161004,181,14.28,37733,2977.13,826,65.17,2398600,189249.54,1867,1229,0.59,187,6,0
1301,台塑         ,20161005,92,7.22,37825,2969.26,-285,-22.37,2398318,188267.96,1495,1869,0.59,92,0,0
1301,台塑         ,20161006,60,4.75,37885,2996.7,1157,91.52,2399444,189796.02,2428,1398,0.6,60,0,0
1301,台塑         ,20161007,183,14.55,38068,3026.41,1499,119.17,2400943,190874.97,2174,861,0.6,183,0,0
1301,台塑         ,20161011,164,13.09,38232,3050.91,2348,187.37,2403291,191782.62,4448,2255,0.6,274,110,0
1301,台塑         ,20161012,130,10.39,38362,3065.12,1871,149.49,2405162,192172.44,2482,828,0.6,130,0,0
1301,台塑         ,20161013,1000,79.4,39362,3125.34,-994,-78.92,2404168,190890.94,3326,5784,0.62,1000,0,0.01
1301,台塑         ,20161014,31,2.47,39393,3139.62,365,29.09,2404533,191641.28,1656,1289,0.62,31,0,0
1301,台塑         ,20161017,202,16.16,39595,3167.6,11,0.88,2404544,192363.52,2087,2252,0.62,202,0,0
1301,台塑         ,20161018,86,6.92,39681,3194.32,2494,200.77,2407259,193784.35,4131,2283,0.62,86,0,0
1301,台塑         ,20161019,1796,147.63,41477,3409.41,4174,343.1,2411272,198206.56,3232,1704,0.65,1796,0,0.01
1301,台塑         ,20161020,6134,521.39,47611,4046.94,5253,446.51,2417065,205450.53,1285,2715,0.75,6134,0,0.05
1301,台塑         ,20161021,464,39.3,48075,4071.95,-1036,-87.75,2416823,204704.91,8210,9817,0.76,464,0,0
1301,台塑         ,20161024,70,5.89,48145,4048.99,-1230,-103.44,2414898,203092.92,1413,2686,0.76,70,0,0
1301,台塑         ,20161025,131,11.14,48276,4103.46,111,9.44,2415020,205276.7,1245,1461,0.76,131,0,0
1301,台塑         ,20161026,381,32.38,48657,4135.85,-1365,-116.03,2414553,205237.01,1039,2978,0.76,381,0,0
1301,台塑         ,20161027,1128,95.77,49785,4226.75,-1927,-163.6,2412626,204831.95,1701,4698,0.78,1128,0,0.01
1301,台塑         ,20161028,388,33.21,50173,4294.81,2220,190.03,2414556,206685.99,3868,2146,0.79,419,31,0
1301,台塑         ,20161031,15,1.28,50188,4286.06,-135,-11.53,2411432,205936.29,2208,2356,0.79,90,75,0
1301,台塑         ,20161101,39,3.32,50227,4269.3,-162,-13.77,2411531,204980.14,1518,1458,0.79,40,1,0
1301,台塑         ,20161102,118,10.01,50345,4259.19,-1674,-141.62,2409688,203859.6,612,2526,0.79,119,1,0
1301,台塑         ,20161103,198,16.81,50543,4291.1,1819,154.43,2411358,204724.29,3483,1898,0.79,198,0,0
1301,台塑         ,20161104,28,2.39,50571,4308.65,997,84.94,2412531,205547.64,3528,2393,0.79,35,7,0
1301,台塑         ,20161107,566,48.39,51137,4372.21,1504,128.59,2413831,206382.55,2439,1715,0.8,566,0,0
1301,台塑         ,20161108,366,31.59,51503,4444.71,4071,351.33,2417861,208661.4,4712,1948,0.81,369,3,0
1301,台塑         ,20161109,71,5.98,51574,4342.53,-2887,-243.09,2415327,203370.53,3532,5251,0.81,93,22,0
1301,台塑         ,20161110,919,79.4,52493,4535.4,5887,508.64,2420861,209162.39,6331,3175,0.82,919,0,0.01
1301,台塑         ,20161111,14,1.19,52507,4463.1,-3742,-318.07,2417129,205455.97,2723,7031,0.82,14,0,0
1301,台塑         ,20161114,-89,-7.57,52418,4460.77,-4653,-395.97,2412741,205324.26,2243,6256,0.82,38,127,0
1301,台塑         ,20161115,603,51.26,53021,4506.79,-2517,-213.95,2410715,204910.78,1630,4650,0.83,621,18,0.01
1301,台塑         ,20161116,-38,-3.25,52983,4530.05,-184,-15.73,2410156,206068.34,2187,2313,0.83,16,54,0
1301,台塑         ,20161117,370,31.89,53353,4599.03,-592,-51.03,2408913,207648.3,1676,2345,0.84,370,0,0
1301,台塑         ,20161118,216,18.51,53569,4590.86,-1961,-168.06,2407040,206283.33,3248,5256,0.84,216,0,0
1301,台塑         ,20161121,0,0,53569,4628.36,448,38.71,2407139,207976.81,1802,1330,0.84,0,0,0
1301,台塑         ,20161122,258,22.7,53827,4736.78,4243,373.38,2411382,212201.62,3215,1419,0.85,266,8,0
1301,台塑         ,20161123,409,36.24,54236,4805.31,2270,201.12,2413661,213850.36,2325,1303,0.85,409,0,0
1301,台塑         ,20161124,106,9.38,54342,4809.27,122,10.8,2413795,213620.86,992,993,0.85,106,0,0
1301,台塑         ,20161125,152,13.38,54494,4795.47,317,27.9,2414168,212446.78,1319,1132,0.86,152,0,0
1301,台塑         ,20161128,149,13.23,54643,4852.3,4872,432.63,2419110,214816.97,5297,833,0.86,149,0,0
1301,台塑         ,20161129,27,2.43,54670,4914.83,2968,266.82,2422099,217746.7,4797,2076,0.86,121,94,0
1301,台塑         ,20161130,455,41.31,55125,5005.35,2280,207.02,2420693,219798.92,8348,6772,0.87,531,76,0
1301,台塑         ,20161201,186,16.94,55311,5038.83,1786,162.7,2422580,220697.04,2527,1334,0.87,186,0,0
1301,台塑         ,20161202,193,17.64,55504,5073.07,-722,-65.99,2421937,221365.04,1451,2196,0.87,193,0,0
1301,台塑         ,20161205,141,12.73,55645,5024.74,-88,-7.95,2421919,218699.29,2091,2339,0.87,251,110,0
1301,台塑         ,20161206,-424,-38.29,55221,4986.46,1125,101.59,2422158,218720.87,2886,1325,0.87,36,460,0
1301,台塑         ,20161207,-138,-12.54,55083,5007.04,2072,188.34,2423814,220324.69,3072,813,0.87,62,200,0
1301,台塑         ,20161208,-413,-37.79,54670,5002.31,5691,520.73,2429506,222299.8,6921,990,0.86,0,413,0
1301,台塑         ,20161209,-185,-17,54485,5007.17,3421,314.39,2432926,223585.9,4418,857,0.86,15,200,0
1301,台塑         ,20161212,-17,-1.56,54468,5005.61,700,64.33,2433626,223650.23,1480,751,0.86,183,200,0
1301,台塑         ,20161213,-74,-6.73,54394,4944.41,491,44.63,2434117,221261.24,2140,1490,0.85,27,101,0
1301,台塑         ,20161214,-428,-38.52,53966,4856.94,2822,253.98,2436949,219325.41,4070,714,0.85,22,450,0
1301,台塑         ,20161215,-537,-47.69,53429,4744.5,779,69.18,2438050,216498.84,3540,1693,0.84,0,537,0
1301,台塑         ,20161216,-129,-11.53,53300,4765.02,-1879,-167.98,2436221,217798.16,4349,6049,0.84,15,144,0
1301,台塑         ,20161219,-511,-45.17,52789,4666.55,-355,-31.38,2436035,215345.49,1621,1336,0.83,85,596,0.01
1301,台塑         ,20161220,-200,-17.74,52589,4664.64,510,45.24,2437068,216167.93,1579,716,0.83,0,200,0
1301,台塑         ,20161221,10,0.89,52599,4681.31,1443,128.43,2438349,217013.06,2751,1475,0.83,48,38,0
1301,台塑         ,20161222,-8,-0.7,52591,4580.68,-2210,-192.49,2436483,212217.67,1123,3015,0.83,10,18,0
1301,台塑         ,20161223,-274,-23.59,52317,4504.49,-1991,-171.43,2434516,209611.83,1964,3668,0.82,0,274,0
1301,台塑         ,20161226,-237,-20.48,52080,4499.71,-382,-33,2434094,210305.72,232,427,0.82,100,337,0
1301,台塑         ,20161227,0,0,52080,4499.71,-228,-19.7,2433961,210294.23,262,395,0.82,0,0,0
1301,台塑         ,20161228,148,13.1,52228,4622.18,226,20,2434740,215474.49,1556,899,0.82,148,0,0
1301,台塑         ,20161229,0,0,52228,4564.73,-1359,-118.78,2433723,212707.39,2069,3091,0.82,0,0,0
1301,台塑         ,20161230,-278,-24.8,48729,4346.63,1333,118.9,2437360,217412.51,2830,1250,0.77,122,400,0
1301,台塑         ,20170103,150,13.52,48879,4404,-394,-35.5,2437086,219581.45,1137,1872,0.77,150,0,0
1301,台塑         ,20170104,-7,-0.63,48872,4413.14,1166,105.29,2438262,220175.06,3302,1900,0.77,293,300,0
1301,台塑         ,20170105,-73,-6.6,48799,4411.43,1228,111.01,2439490,220529.9,4458,3208,0.77,427,500,0.01
1301,台塑         ,20170106,-464,-41.99,48335,4374.32,2050,185.53,2441550,220960.28,3982,987,0.76,112,576,0.01
1301,台塑         ,20170109,-6,-0.54,48329,4359.28,555,50.06,2442105,220277.87,1530,629,0.76,120,126,0
1301,台塑         ,20170110,-46,-4.12,48283,4321.33,19,1.7,2442134,218570.99,3152,1467,0.76,35,81,0
1301,台塑         ,20170111,48,4.29,48331,4315.96,2174,194.14,2444308,218276.7,3209,815,0.76,85,37,0
1301,台塑         ,20170112,-77,-6.99,48254,4381.46,3920,355.94,2448251,222301.19,4828,1116,0.76,43,120,0
1301,台塑         ,20170113,-270,-24.57,47984,4366.54,1932,175.81,2449851,222936.44,3380,1134,0.75,30,300,0
1301,台塑         ,20170116,-193,-17.25,47791,4272.52,108,9.66,2449958,219026.25,1210,1122,0.75,0,193,0
1301,台塑         ,20170117,-38,-3.42,47753,4297.77,1805,162.45,2451763,220658.67,2811,611,0.75,28,66,0
1301,台塑         ,20170118,-308,-26.98,47445,4156.18,-5162,-452.19,2446674,214328.64,1886,5181,0.75,0,308,0
1301,台塑         ,20170119,-633,-55.7,46812,4119.46,-818,-71.98,2445856,215235.33,3040,3179,0.74,0,633,0
1301,台塑         ,20170120,-41,-3.63,46771,4139.23,101,8.94,2445957,216467.19,2004,1900,0.73,0,41,0
1301,台塑         ,20170123,11,0.99,46782,4196.35,1881,168.73,2447770,219564.97,5156,3140,0.73,11,0,0
1301,台塑         ,20170124,34,3.07,46816,4222.8,843,76.04,2447425,220757.73,5789,4996,0.74,34,0,0
1301,台塑         ,20170202,-262,-23.32,46554,4143.31,-2856,-254.18,2445186,217621.55,5816,8278,0.73,0,262,0
1301,台塑         ,20170203,-165,-14.69,46389,4128.62,-2586,-230.15,2442980,217425.22,1858,3900,0.73,48,213,0
1301,台塑         ,20170206,-20,-1.8,46369,4163.94,-943,-84.68,2442087,219299.41,2812,3684,0.73,0,20,0
1301,台塑         ,20170207,-509,-46.17,45860,4159.5,204,18.5,2442587,221542.64,2426,1603,0.72,0,509,0
1301,台塑         ,20170208,-92,-8.3,45768,4128.27,-3939,-355.3,2438925,219991.04,3707,7276,0.72,0,92,0
1301,台塑         ,20170209,-309,-27.87,45459,4100.4,-1089,-98.23,2437841,219893.26,2693,3480,0.71,12,321,0
1301,台塑         ,20170210,-1,-0.09,45458,4204.86,3670,339.48,2441196,225810.63,5403,2056,0.71,50,51,0
1301,台塑         ,20170213,45,4.18,45503,4231.78,1544,143.59,2442708,227171.84,3208,1766,0.71,45,0,0
1301,台塑         ,20170214,238,22.02,45741,4231.04,-1527,-141.25,2441209,225811.83,3331,5078,0.72,278,40,0
1301,台塑         ,20170215,43,4.15,45784,4418.16,5759,555.74,2447287,236163.2,9878,3853,0.72,58,15,0
1301,台塑         ,20170216,50,4.7,45834,4308.4,-12,-1.13,2447344,230050.34,7139,7158,0.72,50,0,0
1301,台塑         ,20170217,2,0.19,45836,4285.67,1430,133.71,2448750,228958.13,2836,1432,0.72,2,0,0
1301,台塑         ,20170218,0,0,45836,4299.42,507,47.56,2449275,229742,525,0,0.72,0,0,0
1301,台塑         ,20170220,-40,-3.74,45796,4281.93,302,28.24,2449885,229064.25,1591,941,0.72,0,40,0
1301,台塑         ,20170221,-109,-10.17,45687,4262.6,552,51.5,2450710,228651.24,1671,737,0.72,0,109,0
1301,台塑         ,20170222,-48,-4.44,45639,4221.61,-881,-81.49,2449962,226621.48,1116,1725,0.72,0,48,0
1301,台塑         ,20170223,-451,-41.72,45188,4179.89,701,64.84,2450749,226694.28,2142,920,0.71,1,452,0
1301,台塑         ,20170224,-150,-13.89,45038,4170.52,85,7.87,2450893,226952.69,2075,1781,0.71,0,150,0
1301,台塑         ,20170301,0,0,45038,4098.46,-1080,-98.28,2450143,222963.01,2139,2889,0.71,0,0,0
1301,台塑         ,20170302,-425,-38.42,44613,4033.02,388,35.08,2450455,221521.13,2431,1693,0.7,0,425,0
1301,台塑         ,20170303,-437,-39.2,44176,3962.59,-1123,-100.73,2449321,219704.09,3842,4540,0.69,3,440,0
1301,台塑         ,20170306,-208,-18.64,43968,3939.53,-610,-54.66,2448610,219395.46,2037,2540,0.69,0,208,0
1301,台塑         ,20170307,19,1.73,43987,3998.42,1321,120.08,2449955,222700.91,2671,1345,0.69,19,0,0
1301,台塑         ,20170308,-192,-17.34,43795,3954.69,-1774,-160.19,2448284,221080.05,1689,3168,0.69,272,464,0.01
1301,台塑         ,20170309,-491,-43.45,43304,3832.4,-5050,-446.93,2442999,216205.41,3913,8707,0.68,50,541,0
1301,台塑         ,20170310,95,8.36,43399,3819.11,230,20.24,2443308,215011.1,2686,2616,0.68,95,0,0
1301,台塑         ,20170313,-541,-47.55,42858,3767.22,-28,-2.46,2443280,214764.31,1552,1108,0.67,0,541,0
1301,台塑         ,20170314,-1206,-107.44,41652,3711.19,919,81.88,2444198,217778.04,3348,1325,0.65,0,1206,0.01
1301,台塑         ,20170315,50,4.47,41702,3728.16,202,18.06,2444400,218529.36,1897,1740,0.66,60,10,0
1301,台塑         ,20170316,50,4.54,41752,3786.91,3330,302.03,2447731,222009.2,4711,1953,0.66,50,0,0
1301,台塑         ,20170317,78,7.12,41830,3819.08,1139,103.99,2448879,223582.65,6570,5496,0.66,78,0,0
1301,台塑         ,20170320,-30,-2.75,41800,3837.24,106,9.73,2448985,224816.82,1297,1193,0.66,0,30,0
1301,台塑         ,20170321,-353,-32.83,41447,3854.57,3685,342.71,2452671,228098.4,5770,1707,0.65,0,353,0
1301,台塑         ,20170322,64,5.9,41511,3827.31,-911,-83.99,2451774,226053.56,2085,2890,0.65,87,23,0
1301,台塑         ,20170323,10,0.93,41521,3840.69,477,44.12,2452278,226835.72,1232,649,0.65,10,0,0
1301,台塑         ,20170324,52,4.83,41573,3862.13,1597,148.36,2453781,227956.25,2823,1199,0.65,52,0,0
1301,台塑         ,20170327,80,7.43,41653,3869.56,1013,94.11,2454824,228053.15,2281,1285,0.65,80,0,0
1301,台塑         ,20170328,80,7.45,41733,3885.34,2940,273.71,2457810,228822.11,5092,2195,0.66,80,0,0
1301,台塑         ,20170329,420,38.88,42153,3903.37,248,22.96,2458076,227617.84,2733,3114,0.66,420,0,0
1301,台塑         ,20170330,94,8.62,42247,3869.83,-157,-14.38,2457956,225148.77,2778,3025,0.66,164,70,0
1301,台塑         ,20170331,119,10.8,41272,3735.12,-537,-48.6,2455685,222239.49,3528,4387,0.65,119,0,0
1301,台塑         ,20170405,197,18.3,41469,3844.18,31,2.87,2455823,227654.79,8837,9051,0.65,197,0,0
1301,台塑         ,20170406,50,4.61,41519,3823.9,-247,-22.75,2455586,226159.47,3469,3922,0.65,50,0,0
1301,台塑         ,20170407,4,0.37,41523,3799.35,-1627,-148.87,2453871,224529.2,3161,4884,0.65,102,98,0
1301,台塑         ,20170410,192,17.82,41715,3871.15,135,12.53,2453768,227709.67,2953,3110,0.66,202,10,0
1301,台塑         ,20170411,205,19.13,41920,3911.14,4639,432.82,2458407,229369.37,7545,3117,0.66,205,0,0
1301,台塑         ,20170412,305,28.21,42225,3905.81,1770,163.73,2460177,227566.37,3915,2642,0.66,332,27,0
1301,台塑         ,20170413,231,21.53,42456,3956.9,2242,208.95,2462419,229497.45,3425,1418,0.67,231,0,0
1301,台塑         ,20170414,83,7.69,42539,3939.11,1731,160.29,2464150,228180.29,3013,1301,0.67,100,17,0
1301,台塑         ,20170417,100,9.27,42639,3952.64,2766,256.41,2466916,228683.11,3584,861,0.67,100,0,0
1301,台塑         ,20170418,98,9.16,42737,3995.91,2934,274.33,2469851,230931.07,3478,600,0.67,98,0,0
1301,台塑         ,20170419,20,1.87,42757,3907.99,-371,-33.91,2469479,225710.38,3303,3771,0.67,106,86,0
1301,台塑         ,20170420,-1036,-94.28,41721,3796.61,-147,-13.38,2469272,224703.75,3036,1892,0.66,2,1038,0.01
1301,台塑         ,20170421,0,0,41721,3825.82,1295,118.75,2470567,226550.99,2393,1032,0.66,0,0,0
1301,台塑         ,20170424,-304,-27.69,41417,3773.09,418,38.08,2470985,225106.73,1832,1096,0.65,0,304,0
1301,台塑         ,20170425,-719,-66.16,40698,3744.22,2256,207.55,2473364,227549.49,4498,1470,0.64,0,719,0.01
1301,台塑         ,20170426,-333,-30.64,40365,3713.58,5320,489.44,2479473,228111.52,8269,1705,0.63,1,334,0
1301,台塑         ,20170427,-56,-5.11,40309,3676.18,950,86.64,2479996,226175.64,1938,1245,0.63,71,127,0
1301,台塑         ,20170428,-297,-26.94,40012,3629.09,-2874,-260.67,2477042,224667.71,2277,4934,0.63,0,297,0
1301,台塑         ,20170502,-25,-2.29,39987,3654.81,987,90.21,2478029,226491.85,2463,1468,0.63,0,25,0
1301,台塑         ,20170503,-20,-1.83,39967,3648.99,-122,-11.14,2478687,226304.12,1493,1661,0.63,0,20,0
1301,台塑         ,20170504,5,0.5,39972,3637.45,742,67.52,2479428,225627.95,2252,1555,0.63,51,46,0
1301,台塑         ,20170505,-429,-38.59,39543,3558.87,-438,-39.42,2478990,223109.1,2641,2849,0.62,37,466,0
1301,台塑         ,20170508,-28,-2.53,39515,3576.11,25,2.26,2479015,224350.86,3331,3265,0.62,0,28,0
1301,台塑         ,20170509,-325,-28.76,39190,3468.32,-4382,-387.81,2474633,219005.02,1414,5565,0.62,0,325,0
1301,台塑         ,20170510,-494,-43.57,38696,3412.99,-2374,-209.39,2472259,218053.24,2383,4445,0.61,0,494,0
1301,台塑         ,20170511,-63,-5.6,38633,3434.47,-1256,-111.66,2471061,219677.32,2823,4343,0.61,7,70,0
1301,台塑         ,20170512,-31,-2.76,38602,3431.72,-1424,-126.59,2469659,219552.69,2448,3844,0.61,0,31,0
1301,台塑         ,20170515,140,12.46,38742,3448.04,-530,-47.17,2468998,219740.82,2556,3329,0.61,250,110,0
1301,台塑         ,20170516,683,60.79,39425,3508.83,-2003,-178.27,2467130,219574.57,2790,5285,0.62,734,51,0.01
1301,台塑         ,20170517,-60,-5.34,39365,3503.49,522,46.46,2467676,219623.16,2398,1833,0.62,0,60,0
1301,台塑         ,20170518,-16,-1.42,39349,3482.39,488,43.19,2468164,218432.51,1570,960,0.62,0,16,0
1301,台塑         ,20170519,-35,-3.08,39314,3459.63,432,38.02,2468596,217236.45,1891,1371,0.62,0,35,0
1301,台塑         ,20170522,-509,-44.79,38805,3414.84,-538,-47.34,2468127,217195.18,4584,4893,0.61,0,509,0
1301,台塑         ,20170523,-9,-0.79,38796,3414.05,442,38.9,2468624,217238.91,3722,3299,0.61,0,9,0
1301,台塑         ,20170524,0,0,38796,3452.84,3036,270.2,2471661,219977.83,3912,1454,0.61,0,0,0
1301,台塑         ,20170525,-6,-0.54,38790,3498.86,3628,327.25,2475288,223270.98,4866,1928,0.61,0,6,0
1301,台塑         ,20170526,-134,-12.05,38656,3475.17,-1005,-90.35,2474077,222419.52,3367,4215,0.61,0,134,0
1301,台塑         ,20170531,26,2.33,38682,3469.78,1800,161.46,2473653,221886.67,10760,8969,0.61,246,220,0
1301,台塑         ,20170601,-380,-33.97,38302,3424.2,1121,100.22,2474775,221244.89,3078,1931,0.6,0,380,0
1301,台塑         ,20170602,-445,-39.74,37857,3380.63,-1245,-111.18,2473530,220886.23,1462,2134,0.59,0,445,0
1301,台塑         ,20170603,-216,-19.31,37641,3365.11,-201,-17.97,2473329,221115.61,55,0,0.59,0,216,0
1301,台塑         ,20170605,-57,-5.1,37584,3363.77,227,20.32,2473501,221378.34,2268,2124,0.59,0,57,0
1301,台塑         ,20170606,-196,-17.68,37388,3372.4,437,39.42,2473882,223144.16,1769,1253,0.59,40,236,0
1301,台塑         ,20170607,989,89.7,38377,3480.79,612,55.51,2474494,224436.61,2552,3051,0.6,1010,21,0.01
1301,台塑         ,20170608,376,33.58,38753,3460.64,-1776,-158.6,2472718,220813.72,1357,3593,0.61,504,128,0
1301,台塑         ,20170609,8,0.72,38761,3488.49,-744,-66.96,2471973,222477.57,3590,4154,0.61,60,52,0
1301,台塑         ,20170612,0,0,38761,3461.36,-3594,-320.94,2468116,220402.76,1511,5129,0.61,0,0,0
1301,台塑         ,20170613,0,0,38761,3480.74,-784,-70.4,2466154,221460.63,899,1574,0.61,0,0,0
1301,台塑         ,20170614,-2,-0.18,38759,3503.81,-570,-51.53,2464121,222756.54,1564,1928,0.61,0,2,0
1301,台塑         ,20170615,-498,-44.87,38261,3447.32,-2389,-215.25,2460030,221648.7,1119,2828,0.6,0,498,0
1301,台塑         ,20170616,-151,-13.53,38110,3414.66,-2886,-258.59,2455764,220036.45,2536,5312,0.6,0,151,0
1301,台塑         ,20170619,-349,-31.65,37761,3424.92,-34,-3.08,2455730,222734.71,724,478,0.59,38,387,0
1301,台塑         ,20170620,370,33.65,38131,3469.92,206,18.75,2455723,223470.79,365,745,0.6,395,25,0
1301,台塑         ,20170621,260,23.58,38391,3482.06,-789,-71.56,2454668,222638.39,3742,5307,0.6,296,36,0
1301,台塑         ,20170622,0,0,38391,3493.58,-233,-21.2,2459196,223786.84,1469,1876,0.6,0,0,0
1301,台塑         ,20170623,-6,-0.55,38385,3512.23,605,55.36,2458874,224986.97,2001,1816,0.6,0,6,0
1301,台塑         ,20170626,-1,-0.09,38384,3581.23,4128,385.14,2461809,229686.78,17699,14297,0.6,94,95,0
1301,台塑         ,20170627,-65,-6.06,38319,3575.16,1023,95.45,2462896,229788.2,2548,2049,0.6,0,65,0
1301,台塑         ,20170628,-78,-7.22,38241,3533.47,-393,-36.31,2462566,227541.1,2212,2543,0.6,0,78,0
1301,台塑         ,20170629,-23,-2.13,38218,3531.34,411,37.98,2462977,227579.07,1342,1016,0.6,0,23,0
1301,台塑         ,20170630,0,0,42382,3928.81,-204,-18.91,2464137,228425.5,2376,2686,0.67,0,0,0
1301,台塑         ,20170703,-483,-44.87,41899,3892.42,-603,-56.02,2463534,228862.31,1515,1674,0.66,0,483,0
1301,台塑         ,20170704,-33,-3.07,41866,3893.54,-1093,-101.65,2462441,229007.01,769,1860,0.66,98,131,0
1301,台塑         ,20170705,64,6.01,41930,3937.23,1171,109.96,2463612,231333.17,2316,1564,0.66,64,0,0
1301,台塑         ,20170706,264,24.79,42194,3962.02,-1592,-149.49,2462020,231183.68,1304,3110,0.66,264,0,0
1301,台塑         ,20170707,0,0,42194,3940.92,-704,-65.75,2461316,229886.91,548,1277,0.66,0,0,0
1301,台塑         ,20170710,-10,-0.92,42184,3889.36,-2036,-187.72,2459133,226732.06,952,3425,0.66,0,10,0
1301,台塑         ,20170711,-3,-0.28,42181,3922.83,1889,175.68,2461023,228875.14,3672,3985,0.66,0,3,0
1301,台塑         ,20170712,3,0.3,42184,3783.9,57,5.11,2461079,220758.79,3282,1400,0.66,23,20,0
1301,台塑         ,20170713,110,10.05,42294,3865.67,570,52.1,2461649,224994.72,3109,2327,0.66,133,23,0
1301,台塑         ,20170714,23,2.08,42317,3829.69,-643,-58.19,2461007,222721.13,1738,2161,0.66,35,12,0
1301,台塑         ,20170717,-75,-6.8,42242,3844.02,563,51.23,2463569,224184.78,1442,676,0.66,6,81,0
1301,台塑         ,20170718,-141,-12.85,42101,3835.4,-530,-48.28,2463039,224382.85,1281,1436,0.66,21,162,0
1301,台塑         ,20170719,0,0,42101,3873.29,592,54.46,2465631,226838.05,2222,1566,0.66,0,0,0
1301,台塑         ,20170720,4,0.37,42105,3861.03,-1001,-91.79,2466331,226162.55,877,1622,0.66,4,0,0
1301,台塑         ,20170721,255,23.33,42360,3875.94,-310,-28.37,2466021,225640.92,906,1470,0.67,400,145,0
1301,台塑         ,20170724,0,0,42360,3897.12,1207,111.04,2467570,227016.44,2281,981,0.67,0,0,0
1301,台塑         ,20170725,-198,-18.06,42162,3845.17,-678,-61.83,2467663,225050.87,1114,1580,0.66,52,250,0
1301,台塑         ,20170726,-7,-0.63,42155,3793.95,-1665,-149.85,2466799,222011.91,918,2297,0.66,0,7,0
1301,台塑         ,20170727,-217,-19.86,41938,3837.33,2062,188.67,2469488,225958.15,2868,709,0.66,50,267,0
1301,台塑         ,20170728,297,27.18,42235,3864.5,935,85.55,2470738,226072.53,1909,1238,0.66,297,0,0
1301,台塑         ,20170731,-73,-6.61,42162,3819.88,-1423,-128.92,2469328,223721.12,5390,6727,0.66,9,82,0
1301,台塑         ,20170801,-12,-1.1,42150,3848.3,-25,-2.28,2469303,225447.36,2706,2828,0.66,5,17,0
1301,台塑         ,20170802,-2,-0.18,42148,3835.47,390,35.49,2469693,224742.06,1026,586,0.66,8,10,0
1301,台塑         ,20170803,297,27.29,42445,3900.7,1400,128.66,2471221,227105.21,2810,1517,0.67,297,0,0
1301,台塑         ,20170804,827,76.41,43272,3998.33,928,85.75,2472195,228430.82,930,784,0.68,861,34,0.01
1301,台塑         ,20170807,31,2.88,43303,4027.18,773,71.89,2472883,229978.12,1271,613,0.68,31,0,0
1301,台塑         ,20170808,821,76.52,44124,4112.36,965,89.94,2473863,230564.03,1575,1417,0.69,827,6,0.01
1301,台塑         ,20170809,71,6.59,44195,4101.3,-646,-59.95,2473688,229558.25,2603,2849,0.69,74,3,0
1301,台塑         ,20170810,1,0.09,44196,4092.55,-320,-29.63,2473471,229043.41,1149,1367,0.69,1,0,0
1301,台塑         ,20170811,-2,-0.18,44194,4065.85,-945,-86.94,2472542,227473.86,609,1536,0.69,3,5,0
1301,台塑         ,20170814,-5,-0.46,44189,4078.64,1516,139.93,2474008,228350.94,1729,259,0.69,0,5,0
1301,台塑         ,20170815,138,12.74,44327,4091.38,130,12,2474201,228368.75,1224,1179,0.7,140,2,0
1301,台塑         ,20170816,502,45.93,44829,4101.85,-357,-32.67,2473911,226362.86,2294,3086,0.7,502,0,0
1301,台塑         ,20170817,0,0,44829,4164.61,1510,140.28,2474593,229889.69,2053,672,0.7,0,0,0
1301,台塑         ,20170818,34,3.16,44863,4163.29,984,91.32,2475734,229748.12,2515,1434,0.7,34,0,0
1301,台塑         ,20170821,41,3.79,44904,4153.62,-83,-7.68,2475699,229002.16,1624,1719,0.71,42,1,0
1301,台塑         ,20170822,90,8.37,44994,4184.44,1540,143.22,2477205,230380.07,2650,1261,0.71,90,0,0
1301,台塑         ,20170823,1110,103.23,46104,4287.67,1559,144.99,2479268,230571.92,2161,1240,0.72,1114,4,0.01
1301,台塑         ,20170824,48,4.49,46152,4315.21,2071,193.64,2480927,231966.67,2575,624,0.73,48,0,0
1301,台塑         ,20170825,-50,-4.7,46102,4328.98,1324,124.32,2482176,233076.33,1876,558,0.72,0,50,0
1301,台塑         ,20170828,-217,-20.51,45885,4336.13,1022,96.58,2483157,234658.34,2358,1189,0.72,2,219,0
1301,台塑         ,20170829,-391,-36.64,45494,4262.79,-745,-69.81,2482416,232602.38,1687,2068,0.71,0,391,0
1301,台塑         ,20170830,-50,-4.7,45444,4271.74,336,31.58,2482941,233396.45,2256,1691,0.71,0,50,0
1301,台塑         ,20170831,-305,-28.64,45139,4238.55,-364,-34.18,2482583,233114.54,2093,2162,0.71,0,305,0
1301,台塑         ,20170901,-120,-11.24,45019,4218.28,-784,-73.46,2481881,232552.25,1117,1711,0.71,26,146,0
1301,台塑         ,20170904,-62,-5.86,44957,4248.44,706,66.72,2482600,234605.7,1855,1074,0.71,0,62,0
1301,台塑         ,20170905,1501,143.05,46458,4427.45,2328,221.86,2484962,236816.88,5781,4936,0.73,1501,0,0.01
1301,台塑         ,20170906,-27,-2.58,46431,4429.52,2728,260.25,2488481,237401.09,7937,5042,0.73,0,27,0
1301,台塑         ,20170907,1489,142.65,47920,4590.74,1983,189.97,2490469,238586.93,2952,2928,0.75,1492,3,0.01
1301,台塑         ,20170908,-4,-0.39,47916,4647.85,3480,337.56,2493990,241917.03,4164,875,0.75,25,29,0
1301,台塑         ,20170911,117,11.22,48033,4606.36,623,59.75,2494638,239235.78,1665,1125,0.75,225,108,0
1301,台塑         ,20170912,34,3.26,48067,4604.82,895,85.74,2495572,239075.8,1704,899,0.76,94,60,0
1301,台塑         ,20170913,-193,-18.34,47874,4548.03,41,3.9,2495613,237083.23,1507,1208,0.75,7,200,0
1301,台塑         ,20170914,216,20.43,48090,4549.31,997,94.32,2496610,236179.31,2356,1686,0.76,219,3,0
1301,台塑         ,20170915,248,23.66,48338,4611.45,1877,179.07,2498487,238355.66,9743,8310,0.76,251,3,0
1301,台塑         ,20170918,72,6.91,48410,4647.36,1444,138.62,2499931,239993.38,2020,525,0.76,371,299,0.01
1301,台塑         ,20170919,-203,-19.24,48207,4570.02,-264,-25.03,2499567,236958.95,1717,1543,0.76,100,303,0
1301,台塑         ,20170920,-227,-21.36,47980,4514.92,377,35.48,2500292,235277.48,1806,533,0.75,0,227,0
1301,台塑         ,20170921,-125,-11.73,47855,4488.8,-450,-42.21,2499941,234494.47,888,1113,0.75,0,125,0
1301,台塑         ,20170922,71,6.6,47926,4457.12,-756,-70.31,2499178,232423.55,940,1774,0.75,71,0,0
1301,台塑         ,20170925,76,7.01,48002,4430.58,289,26.67,2499491,230703.02,1931,1694,0.75,113,37,0
1301,台塑         ,20170926,227,21.07,48229,4475.65,317,29.42,2499300,231935.04,1374,1211,0.76,339,112,0
1301,台塑         ,20170927,90,8.34,48319,4479.17,-296,-27.44,2498976,231655.08,1092,1457,0.76,96,6,0
1301,台塑         ,20170928,16,1.46,48335,4422.65,-559,-51.15,2496213,228403.49,2663,3058,0.76,16,0,0
1301,台塑         ,20170929,-2,-0.18,48333,4436.97,1510,138.62,2497497,229270.22,3614,2231,0.76,0,2,0
1301,台塑         ,20170930,-170,-15.61,43832,4023.78,-153,-14.05,2492996,228857.03,0,0,0.69,80,250,0
1301,台塑         ,20171002,62,5.69,43894,4029.47,363,33.32,2493359,228890.36,1431,1179,0.69,62,0,0
1301,台塑         ,20171003,-586,-53.46,43308,3949.69,-226,-20.61,2493256,227384.95,2687,2327,0.68,7,593,0
1301,台塑         ,20171005,-45,-4.1,43263,3945.59,1038,94.67,2494294,227479.61,2274,1240,0.68,75,120,0
1301,台塑         ,20171006,20,1.84,43283,3982.04,468,43.06,2494762,229518.1,2074,1641,0.68,20,0,0
1301,台塑         ,20171011,56,5.29,43339,4091.2,2398,226.37,2497160,235731.9,5523,3382,0.68,61,5,0
1301,台塑         ,20171012,40,3.78,43379,4103.65,968,91.57,2497628,236275.61,4018,2954,0.68,40,0,0
1301,台塑         ,20171013,46,4.3,43425,4060.24,-2058,-192.42,2495570,233335.8,1047,3160,0.68,46,0,0
1301,台塑         ,20171016,80,7.46,43505,4054.67,425,39.61,2495995,232626.73,2311,2021,0.68,86,6,0
1301,台塑         ,20171017,994,92.94,44499,4160.66,2524,235.99,2498519,233611.53,3937,2398,0.7,1000,6,0.01
1301,台塑         ,20171018,297,27.62,44796,4166.03,528,49.1,2499047,232411.37,3055,2648,0.7,300,3,0
1301,台塑         ,20171019,-30,-2.78,44766,4154.28,-153,-14.2,2498894,231897.36,1214,1376,0.7,0,30,0
1301,台塑         ,20171020,58,5.38,44824,4159.67,742,68.86,2499636,231966.22,3183,2509,0.7,58,0,0
1301,台塑         ,20171023,-1450,-132.97,43374,3977.4,-1082,-99.22,2499590,229212.4,1153,801,0.68,0,1450,0.01
1301,台塑         ,20171024,-5,-0.46,43369,3989.95,131,12.05,2499721,229974.33,1962,1814,0.68,0,5,0
1301,台塑         ,20171025,-135,-12.42,43234,3977.53,850,78.2,2501270,230116.84,1802,822,0.68,24,159,0
1301,台塑         ,20171026,-191,-17.57,43043,3959.96,-385,-35.42,2500904,230083.17,929,988,0.68,46,237,0
1301,台塑         ,20171027,28,2.57,43071,3958.22,-429,-39.43,2500548,229800.36,575,959,0.68,37,9,0
1301,台塑         ,20171030,0,0,43071,3945.3,-568,-52.03,2500001,229000.09,1142,1689,0.68,0,0,0
1301,台塑         ,20171031,1,0.09,43072,3958.32,97,8.91,2500506,229796.5,2671,2612,0.68,1,0,0
1301,台塑         ,20171101,-94,-8.59,42978,3928.19,-1310,-119.73,2499370,228442.42,967,2110,0.68,6,100,0
1301,台塑         ,20171102,-46,-4.25,42932,3928.28,-135,-12.35,2499161,228673.23,812,1070,0.67,22,68,0
1301,台塑         ,20171103,101,9.34,43033,3980.55,12,1.11,2499172,231173.41,618,617,0.68,101,0,0
1301,台塑         ,20171106,-77,-7.07,42956,3943.36,-1451,-133.2,2497731,229291.71,705,2064,0.67,10,87,0
1301,台塑         ,20171107,-599,-55.53,42357,3926.49,-997,-92.42,2497023,231474.03,1238,1631,0.67,0,599,0
1301,台塑         ,20171108,41,3.78,42398,3913.34,-505,-46.61,2496575,230433.87,1020,1510,0.67,434,393,0.01
1301,台塑         ,20171109,-26,-2.39,42372,3902.46,53,4.88,2496618,229938.52,2416,2346,0.67,4,30,0
1301,台塑         ,20171110,46,4.24,42418,3906.7,555,51.12,2497169,229989.26,3213,2708,0.67,46,0,0
1301,台塑         ,20171113,206,19.16,42624,3964.03,-9,-0.84,2497103,232230.58,2363,2729,0.67,206,0,0
1301,台塑         ,20171114,-10,-0.93,42614,3946.06,-868,-80.38,2496235,231151.36,1347,2138,0.67,0,10,0
1301,台塑         ,20171115,49,4.54,42663,3954.86,-1546,-143.31,2494738,231262.21,2956,4475,0.67,49,0,0
1301,台塑         ,20171116,362,33.41,43025,3971.21,-293,-27.04,2494680,230258.96,2041,2461,0.68,362,0,0
1301,台塑         ,20171117,281,25.88,43306,3988.48,-1045,-96.24,2493861,229684.6,2089,3189,0.68,283,2,0
1301,台塑         ,20171120,25,2.31,43331,4008.12,-981,-90.74,2492879,230591.31,1114,2121,0.68,55,30,0
1301,台塑         ,20171121,-245,-22.56,43086,3968.22,-419,-38.59,2492460,229555.57,3335,3509,0.68,213,458,0.01
1301,台塑         ,20171122,69,6.38,43155,3991.84,1135,104.99,2493528,230651.34,6399,5399,0.68,69,0,0
1301,台塑         ,20171123,-120,-11.21,43035,4019.47,1360,127.02,2494969,233030.1,4870,3309,0.68,24,144,0
1301,台塑         ,20171124,16,1.48,43051,3982.22,-465,-43.01,2494478,230739.22,2843,3350,0.68,93,77,0
1301,台塑         ,20171127,-139,-12.97,42912,4003.69,5,0.47,2494316,232719.68,4383,4406,0.67,0,139,0
1301,台塑         ,20171128,-39,-3.64,42873,4004.34,139,12.98,2494732,233007.97,4349,4065,0.67,0,39,0
1301,台塑         ,20171129,-23,-2.15,42850,4010.76,4,0.37,2494694,233503.36,4821,4824,0.67,19,42,0
1301,台塑         ,20171130,-1304,-118.14,41546,3764.07,-3517,-318.64,2491170,225700,12961,15181,0.65,2,1306,0.01
1301,台塑         ,20171201,-4,-0.37,41542,3855.1,127,11.79,2491305,231193.1,2819,2680,0.65,4,8,0
1301,台塑         ,20171204,47,4.39,41589,3880.25,-1656,-154.5,2489641,232283.51,1141,3027,0.65,47,0,0
1301,台塑         ,20171205,543,50.83,42132,3943.56,901,84.33,2490542,233114.73,3292,2898,0.66,543,0,0
1301,台塑         ,20171206,27,2.51,42159,3920.79,-2081,-193.53,2488538,231434.03,1306,3199,0.66,27,0,0
1301,台塑         ,20171207,665,61.85,42824,3982.63,-1160,-107.88,2487301,231318.99,1440,3378,0.67,667,2,0.01
1301,台塑         ,20171208,24,2.23,42848,3984.86,-1752,-162.94,2485488,231150.38,2191,4044,0.67,24,0,0
1301,台塑         ,20171211,-43,-3.99,42805,3976.58,-857,-79.62,2484570,230816.55,861,1630,0.67,3,46,0
1301,台塑         ,20171212,2,0.19,42807,3993.89,-1612,-150.4,2482773,231642.72,1822,3439,0.67,18,16,0
1301,台塑         ,20171213,15,1.4,42822,4003.86,-274,-25.62,2482451,232109.17,2476,2720,0.67,15,0,0
1301,台塑         ,20171214,28,2.63,42850,4023.62,-280,-26.29,2482171,233075.86,3281,3684,0.67,28,0,0
1301,台塑         ,20171215,158,14.74,43008,4012.65,-1885,-175.87,2480286,231410.68,5844,7948,0.68,218,60,0
1301,台塑         ,20171218,389,36.84,43397,4109.7,932,88.26,2480620,234914.71,2811,2654,0.68,389,0,0
1301,台塑         ,20171219,20,1.9,43417,4115.93,-837,-79.35,2479783,235083.43,3018,3850,0.68,20,0,0
1301,台塑         ,20171220,374,35.46,43791,4151.39,-405,-38.39,2479280,235035.74,1122,1804,0.69,374,0,0
1301,台塑         ,20171221,1084,102.87,44875,4258.64,71,6.74,2479302,235285.76,738,1710,0.7,1084,0,0.01
1301,台塑         ,20171222,446,42.55,45321,4323.62,74,7.06,2479376,236532.47,3911,4386,0.71,446,0,0
1301,台塑         ,20171225,-70,-6.72,45251,4344.1,207,19.87,2479583,238039.97,593,364,0.71,0,70,0
1301,台塑         ,20171226,126,12.08,45377,4356.19,238,22.85,2479821,238062.82,829,735,0.71,127,1,0
1301,台塑         ,20171227,363,35.76,45740,4505.39,1483,146.08,2481304,244408.44,2446,1997,0.72,439,76,0
1301,台塑         ,20171228,362,35.08,46102,4467.28,3618,350.58,2484922,240788.94,4455,1244,0.72,362,0,0
1301,台塑         ,20171229,1000,98.7,46040,4544.15,4557,449.78,2487791,245544.97,4821,1367,0.72,1100,100,0.01
1301,台塑         ,20180102,198,19.42,46238,4535.95,201,19.72,2487991,244071.92,1162,1386,0.73,198,0,0
1301,台塑         ,20180103,-109,-10.74,46129,4543.71,-1477,-145.48,2486514,244921.63,1193,2635,0.72,300,409,0.01
1301,台塑         ,20180104,-151,-14.87,45978,4528.83,-107,-10.54,2486408,244911.19,2168,2468,0.72,0,151,0
1301,台塑         ,20180105,-290,-28.54,45688,4495.7,512,50.38,2486919,244712.83,3125,2208,0.72,0,290,0
1301,台塑         ,20180108,161,16.02,45849,4561.98,2907,289.25,2489888,247743.86,6218,4267,0.72,161,0,0
1301,台塑         ,20180109,411,42.13,46260,4741.65,5060,518.65,2494948,255732.17,7409,3778,0.73,445,34,0
1301,台塑         ,20180110,69,6.97,46329,4679.23,-2267,-228.97,2492681,251760.78,3963,6669,0.73,84,15,0
1301,台塑         ,20180111,1123,113.42,47452,4792.65,2612,263.81,2495231,252018.33,4178,1700,0.75,1123,0,0.01
1301,台塑         ,20180112,907,92.06,48359,4908.44,3711,376.67,2498942,253642.61,5180,1686,0.76,914,7,0.01
1301,台塑         ,20180115,1300,132.6,49659,5065.22,2556,260.71,2501498,255152.8,3029,1464,0.78,1302,2,0.01
1301,台塑         ,20180116,67,6.83,49726,5072.05,1335,136.17,2502833,255288.97,2039,864,0.78,86,19,0
1301,台塑         ,20180117,10,1.02,49736,5073.07,2061,210.22,2504895,255499.29,4363,2152,0.78,10,0,0
1301,台塑         ,20180118,10,1.01,49746,5049.22,140,14.21,2505034,254260.95,3603,3392,0.78,10,0,0
1301,台塑         ,20180119,-56,-5.63,49690,4993.85,-339,-34.07,2505112,251763.76,4970,5234,0.78,0,56,0
1301,台塑         ,20180122,-34,-3.45,49656,5040.08,-822,-83.43,2504290,254185.44,2719,3280,0.78,14,48,0
1301,台塑         ,20180123,-161,-16.1,49495,4949.5,-1159,-115.9,2503131,250313.1,2986,4111,0.78,0,161,0
1301,台塑         ,20180124,666,66.04,50161,4975.97,1842,182.73,2504998,248495.8,3098,2013,0.79,696,30,0.01
1301,台塑         ,20180125,0,0,50161,5091.34,4658,472.79,2509754,254740.03,6500,1944,0.79,0,0,0
1301,台塑         ,20180126,-226,-23.39,49935,5168.27,5043,521.95,2514797,260281.49,9921,5020,0.78,125,351,0
1301,台塑         ,20180129,325,33.96,50260,5252.17,569,59.46,2515367,262855.85,2613,2398,0.79,325,0,0
1301,台塑         ,20180130,0,0,50260,5176.78,1131,116.49,2516199,259168.5,5151,3967,0.79,0,0,0
1301,台塑         ,20180131,-116,-12.01,50144,5189.9,3179,329.03,2517393,260550.18,8123,5048,0.79,8,124,0
1301,台塑         ,20180201,354,36.46,50498,5201.29,3122,321.57,2520529,259614.49,4181,1399,0.79,547,193,0.01
1301,台塑         ,20180202,22,2.2,50520,5052,-1456,-145.6,2519047,251904.7,1976,3606,0.79,80,58,0
1301,台塑         ,20180205,146,14.67,50666,5091.93,461,46.33,2519661,253225.93,3429,2824,0.8,156,10,0
1301,台塑         ,20180206,82,7.93,50748,4907.33,-6976,-674.58,2513279,243034.08,3943,10406,0.8,98,16,0
1301,台塑         ,20180207,73,7.37,50821,5132.92,-1219,-123.12,2511895,253701.39,7914,9192,0.8,89,16,0
1301,台塑         ,20180208,-146,-14.6,50675,5067.5,-2199,-219.9,2509662,250966.2,3709,5676,0.8,59,205,0
1301,台塑         ,20180209,71,6.94,50746,4962.96,-6695,-654.77,2502454,244740,4524,11707,0.8,81,10,0
1301,台塑         ,20180212,-162,-16.36,50584,5108.98,249,25.15,2502709,252773.61,4962,4545,0.79,99,261,0
1301,台塑         ,20180221,67,6.97,50651,5267.7,3837,399.05,2506789,260706.06,8037,4023,0.8,67,0,0
1301,台塑         ,20180222,-200,-20.5,50451,5171.23,-1178,-120.75,2504970,256759.43,2514,4049,0.79,0,200,0
1301,台塑         ,20180223,-34,-3.54,50417,5243.37,208,21.63,2505180,260538.72,2629,2385,0.79,4,38,0
1301,台塑         ,20180226,49,5.07,50466,5223.23,910,94.19,2505965,259367.38,3956,3232,0.79,55,6,0
1301,台塑         ,20180227,111,11.49,50577,5234.72,1090,112.82,2507078,259482.57,5032,4017,0.79,121,10,0
1301,台塑         ,20180301,-3,-0.31,50574,5158.55,-1611,-164.32,2505467,255557.63,3147,5103,0.79,10,13,0
1301,台塑         ,20180302,-220,-22.11,50354,5060.58,-2846,-286.02,2502621,251513.41,1840,4378,0.79,3,223,0
1301,台塑         ,20180305,-7,-0.71,50347,5085.05,-1859,-187.76,2500718,252572.52,2706,4524,0.79,0,7,0
1301,台塑         ,20180306,-27,-2.74,50320,5107.48,-323,-32.78,2500395,253790.09,1550,1933,0.79,30,57,0
1301,台塑         ,20180307,-2,-0.2,50318,5107.28,-184,-18.68,2500211,253771.42,4893,5121,0.79,0,2,0
1301,台塑         ,20180308,-154,-15.63,50164,5091.65,-754,-76.53,2499457,253694.89,1854,2517,0.79,10,164,0
1301,台塑         ,20180309,-1074,-109.01,49090,4982.64,-1399,-142,2498058,253552.89,1242,1600,0.77,2,1076,0.01
1301,台塑         ,20180312,-140,-14.49,48950,5066.33,1520,157.32,2499578,258706.32,2541,970,0.77,1,141,0
1301,台塑         ,20180313,-792,-81.58,48158,4960.27,-460,-47.38,2499119,257409.26,2402,2085,0.76,0,792,0.01
1301,台塑         ,20180314,-621,-63.34,47537,4848.77,-1584,-161.57,2497535,254748.57,6650,7814,0.75,0,621,0
1301,台塑         ,20180315,-95,-9.69,47442,4839.08,-10,-1.02,2497524,254747.45,1270,1179,0.75,0,95,0
1301,台塑         ,20180316,-358,-36.52,47084,4802.57,-1436,-146.47,2496088,254600.98,8398,9530,0.74,0,358,0
1301,台塑         ,20180319,-123,-12.67,46961,4836.98,1312,135.14,2497400,257232.2,1910,518,0.74,0,123,0
1301,台塑         ,20180320,-30,-3.15,46931,4927.76,5549,582.65,2502950,262809.75,7170,1787,0.74,0,30,0
1301,台塑         ,20180321,-16,-1.7,46915,4996.45,3240,345.06,2506189,266909.13,6661,3431,0.74,522,538,0.01
1301,台塑         ,20180322,38,3.95,46953,4883.11,3683,383.03,2508835,260918.84,8160,4665,0.74,208,170,0
1301,台塑         ,20180323,-48,-5.02,46905,4901.57,329,34.38,2509164,262207.64,3863,3381,0.74,88,136,0
1301,台塑         ,20180326,127,13.11,47032,4867.81,-402,-41.61,2508763,259656.97,972,1457,0.74,229,102,0
1301,台塑         ,20180327,-50,-5.29,46982,4933.11,1734,182.07,2510351,263586.86,3180,1243,0.74,0,50,0
1301,台塑         ,20180328,-322,-33.17,46660,4805.98,-753,-77.56,2509599,258488.7,1641,1992,0.73,0,322,0
1301,台塑         ,20180329,4,0.41,46664,4806.39,59,6.08,2509658,258494.77,3843,3661,0.73,30,26,0
1301,台塑         ,20180330,-574,-59.41,46090,4770.31,-4,-0.41,2509654,259749.19,2189,1608,0.72,49,623,0.01
1301,台塑         ,20180331,29,3.02,45293,4710.47,69,7.18,2508173,260849.99,34,13,0.71,29,0,0
1301,台塑         ,20180402,-209,-21.42,45084,4621.11,535,54.84,2508745,257146.36,1416,635,0.71,23,232,0
1301,台塑         ,20180403,-424,-43.25,44660,4555.32,92,9.38,2509068,255924.94,2751,2004,0.7,0,424,0
1301,台塑         ,20180409,8,0.84,44668,4690.14,3183,334.22,2512402,263802.21,5326,2053,0.7,8,0,0
1301,台塑         ,20180410,-3,-0.32,44665,4712.16,1065,112.36,2513520,265176.36,2815,1694,0.7,8,11,0
1301,台塑         ,20180411,128,13.5,44793,4725.66,1033,108.98,2514456,265275.11,2274,1586,0.7,128,0,0
1301,台塑         ,20180412,60,6.39,44853,4776.84,617,65.71,2515055,267853.36,1980,1426,0.7,195,135,0
1301,台塑         ,20180413,515,54.85,45368,4831.69,120,12.78,2515078,267855.81,1728,2252,0.71,642,127,0.01
1301,台塑         ,20180416,21,2.26,45389,4879.32,419,45.04,2515506,270416.9,2066,1609,0.71,663,642,0.01
1301,台塑         ,20180417,-537,-56.91,44852,4754.31,-765,-81.09,2515311,266622.97,3442,3130,0.7,782,1319,0.02
1301,台塑         ,20180418,456,48.34,45308,4802.65,1779,188.57,2517134,266816.2,2019,652,0.71,490,34,0
1301,台塑         ,20180419,-324,-34.19,44984,4745.81,-1082,-114.15,2515995,265437.47,4274,5089,0.71,215,539,0.01
1301,台塑         ,20180420,-685,-72.98,44299,4717.84,1718,182.97,2517691,268134.09,3968,1587,0.7,3,688,0.01
1301,台塑         ,20180423,-31,-3.27,44268,4670.27,1321,139.37,2519097,265764.73,2130,693,0.7,3,34,0
1301,台塑         ,20180424,290,30.16,44558,4634.03,534,55.54,2519357,262013.13,1416,1351,0.7,312,22,0
1301,台塑         ,20180425,-101,-10.4,44457,4579.07,466,48,2519568,259515.5,1699,1339,0.7,31,132,0
1301,台塑         ,20180426,0,0,44457,4623.53,807,83.93,2520040,262084.16,2880,1957,0.7,0,0,0
1301,台塑         ,20180427,0,0,44457,4645.76,490,51.21,2520429,263384.83,1839,1343,0.7,0,0,0
1301,台塑         ,20180430,253,26.44,44710,4672.2,-412,-43.05,2519118,263247.83,2357,3174,0.7,253,0,0
1301,台塑         ,20180502,291,30.7,45001,4747.61,713,75.22,2519831,265842.17,1961,1563,0.71,303,12,0
1301,台塑         ,20180503,296,30.93,45297,4733.54,-1485,-155.18,2517867,263117.1,1186,3071,0.71,296,0,0
1301,台塑         ,20180504,1830,192.15,47127,4948.34,1180,123.9,2518969,264491.75,2085,2427,0.74,1830,0,0.01
1301,台塑         ,20180507,-331,-34.95,46796,4936.98,-112,-11.82,2518885,265742.37,1343,1096,0.74,0,331,0
1301,台塑         ,20180508,315,33.25,47111,4970.21,-163,-17.2,2518723,265725.28,1879,2297,0.74,315,0,0
1301,台塑         ,20180509,13,1.37,47124,4971.58,1075,113.41,2519805,265839.43,2765,1696,0.74,51,38,0
1301,台塑         ,20180510,6,0.64,47130,4995.78,1843,195.36,2521656,267295.54,3121,1276,0.74,6,0,0
1301,台塑         ,20180511,110,11.94,47240,5125.54,4785,519.17,2526365,274110.6,5165,566,0.74,110,0,0
1301,台塑         ,20180514,-12,-1.33,47228,5242.31,1418,157.4,2527803,280586.13,4101,2664,0.74,351,363,0.01
1301,台塑         ,20180515,0,0,47228,5218.69,1332,147.19,2529566,279517.04,8198,6719,0.74,0,0,0
1301,台塑         ,20180516,-505,-56.06,46723,5186.25,-125,-13.88,2529445,280768.4,5385,5001,0.73,0,505,0
1301,台塑         ,20180517,28,3.12,46751,5212.74,-238,-26.54,2528843,281965.99,2818,3601,0.73,28,0,0
1301,台塑         ,20180518,997,111.66,47748,5347.78,913,102.26,2529756,283332.67,2108,2304,0.75,1011,14,0.01
1301,台塑         ,20180521,105,11.81,47853,5383.46,1039,116.89,2530823,284717.59,1901,1056,0.75,105,0,0
1301,台塑         ,20180522,405,44.35,48258,5284.25,-1189,-130.2,2529857,277019.34,1820,3414,0.76,435,30,0
1301,台塑         ,20180523,46,5.1,48304,5313.44,-1217,-133.87,2528498,278134.78,1890,3077,0.76,46,0,0
1301,台塑         ,20180524,-154,-17.09,48150,5344.65,788,87.47,2529347,280757.52,2512,1578,0.76,0,154,0
1301,台塑         ,20180525,-10,-1.09,48140,5223.19,-497,-53.92,2528573,274350.17,2130,2542,0.76,0,10,0
1301,台塑         ,20180528,-20,-2.2,48120,5293.2,-220,-24.2,2528517,278136.87,1690,1524,0.76,0,20,0
1301,台塑         ,20180529,-9,-0.99,48111,5292.21,-720,-79.2,2527967,278076.37,1443,2114,0.76,0,9,0
1301,台塑         ,20180530,-320,-34.72,47791,5185.32,-2371,-257.25,2525228,273987.24,4067,6291,0.75,0,320,0
1301,台塑         ,20180531,37,3.98,47828,5141.51,-2757,-296.38,2523754,271303.56,18229,21164,0.75,42,5,0
1301,台塑         ,20180601,-260,-28.47,47568,5208.7,61,6.68,2523854,276362.01,3150,2790,0.75,0,260,0
1301,台塑         ,20180604,-54,-5.97,47514,5250.3,-498,-55.03,2523317,278826.53,2233,2757,0.75,0,54,0
1301,台塑         ,20180605,-14,-1.53,47500,5201.25,-735,-80.48,2522582,276222.73,1889,2718,0.75,1,15,0
1301,台塑         ,20180606,-641,-70.19,46859,5131.06,-974,-106.65,2521622,276117.61,2691,3099,0.74,0,641,0.01
1301,台塑         ,20180607,169,18.59,47028,5173.08,-92,-10.12,2520550,277260.5,3379,3649,0.74,197,28,0
1301,台塑         ,20180608,-1060,-115.01,45968,4987.53,-3451,-374.43,2515417,272922.74,2422,4787,0.72,0,1060,0.01
1301,台塑         ,20180611,-422,-46,45546,4964.51,-731,-79.68,2513005,273917.54,3012,3355,0.72,128,550,0.01
1301,台塑         ,20180612,-245,-26.34,45301,4869.86,-3014,-324.01,2509066,269724.59,2417,5290,0.71,0,245,0
1301,台塑         ,20180613,-801,-86.11,44500,4783.75,-3019,-324.54,2505016,269289.22,1575,3990,0.7,0,801,0.01
1301,台塑         ,20180614,-99,-10.54,44401,4728.71,-4242,-451.77,2499771,266225.61,1190,5462,0.7,0,99,0
1301,台塑         ,20180615,-162,-17.17,44239,4689.33,-1009,-106.95,2501289,265136.63,8172,9225,0.69,0,162,0
1301,台塑         ,20180619,198,20.89,44437,4688.1,-1905,-200.98,2507383,264528.91,3779,5882,0.7,214,16,0
1301,台塑         ,20180620,16,1.69,44453,4778.7,-1585,-170.39,2507640,269571.3,2428,4319,0.7,25,9,0
1301,台塑         ,20180621,-28,-3.04,44425,4820.11,-2957,-320.83,2503824,271664.9,1766,4585,0.7,0,28,0
1301,台塑         ,20180622,-5,-0.55,44420,4863.99,-782,-85.63,2501580,273923.01,2225,3157,0.7,0,5,0
1301,台塑         ,20180625,0,0,44420,4886.2,-3173,-349.03,2497547,274730.17,1959,5869,0.7,0,0,0
1301,台塑         ,20180626,42,4.62,44462,4890.82,-624,-68.64,2495745,274531.95,1606,2533,0.7,42,0,0
1301,台塑         ,20180627,-713,-78.43,43749,4812.39,-2238,-246.18,2485507,273405.77,2220,3846,0.69,7,720,0.01
1301,台塑         ,20180628,3,0.33,43752,4768.97,-41,-4.47,2485476,270916.88,3934,4073,0.69,3,0,0
1301,台塑         ,20180629,-6,-0.68,54172,6094.35,-243,-27.34,2494489,280630.01,4007,4107,0.85,0,6,0
1301,台塑         ,20180702,-508,-57.15,53664,6037.2,-5561,-625.61,2488928,280004.4,1418,6436,0.84,0,508,0
1301,台塑         ,20180703,17,1.92,53681,6065.95,-3741,-422.73,2485052,280810.88,1426,5112,0.84,50,33,0
1301,台塑         ,20180704,-235,-26.79,53446,6092.84,-1440,-164.16,2483612,283131.77,2125,3570,0.84,0,235,0
1301,台塑         ,20180705,6,0.68,53452,6066.8,-1957,-222.12,2481656,281667.96,2358,4275,0.84,6,0,0
1301,台塑         ,20180706,-18,-1.97,53434,5851.02,-1732,-189.65,2479924,271551.68,4368,6209,0.84,9,27,0
1301,台塑         ,20180709,0,0,53434,5931.17,2092,232.21,2482016,275503.78,6208,4119,0.84,0,0,0
1301,台塑         ,20180710,0,0,53434,5984.61,1881,210.67,2483897,278196.46,3245,1791,0.84,0,0,0
1301,台塑         ,20180711,34,3.6,53468,5667.61,-680,-72.08,2480517,262934.8,5840,6169,0.84,92,58,0
1301,台塑         ,20180712,52,5.51,53520,5673.12,3455,366.23,2483973,263301.14,5551,2258,0.84,58,6,0
1301,台塑         ,20180713,-9,-0.99,53511,5886.21,4430,487.3,2489139,273805.29,5775,1330,0.84,0,9,0
1301,台塑         ,20180716,-118,-12.8,53393,5793.14,2585,280.47,2498023,271035.5,4014,1445,0.84,0,118,0
1301,台塑         ,20180717,-82,-8.77,53311,5704.28,556,59.49,2498431,267332.12,2711,1988,0.84,0,82,0
1301,台塑         ,20180718,-7,-0.76,53304,5783.48,1390,150.82,2500946,271352.64,3742,2402,0.84,0,7,0
1301,台塑         ,20180719,0,0,53304,5730.18,1962,210.92,2504443,269227.62,3101,1039,0.84,0,0,0
1301,台塑         ,20180720,-515,-55.36,52789,5674.82,1261,135.56,2506078,269403.39,2711,873,0.83,0,515,0
1301,台塑         ,20180723,-189,-20.51,52600,5707.1,2472,268.21,2508937,272219.66,4716,1951,0.83,378,567,0.01
1301,台塑         ,20180724,-324,-35.48,52276,5724.22,1843,201.81,2510780,274930.41,4062,1857,0.82,37,361,0
1301,台塑         ,20180725,201,21.81,52477,5693.75,3251,352.73,2513326,272695.87,4662,1612,0.82,201,0,0
1301,台塑         ,20180726,82,9.1,52559,5834.05,6314,700.85,2519436,279657.4,6870,725,0.83,100,18,0
1301,台塑         ,20180727,-231,-25.53,52328,5782.24,3087,341.11,2522523,278738.79,5871,2893,0.82,41,272,0
1301,台塑         ,20180730,-24,-2.68,52304,5831.9,3260,363.49,2525773,281623.69,4208,1202,0.82,0,24,0
1301,台塑         ,20180731,-19,-2.14,52285,5882.06,4260,479.25,2528211,284423.74,6739,2373,0.82,1,20,0
1301,台塑         ,20180801,102,11.53,52387,5919.73,5375,607.38,2527345,285589.98,7042,1982,0.82,127,25,0
1301,台塑         ,20180802,-112,-12.54,52275,5854.8,1460,163.52,2529337,283285.74,5160,2868,0.82,0,112,0
1301,台塑         ,20180803,454,50.62,52729,5879.28,1436,160.11,2531158,282224.12,2516,1217,0.83,489,35,0
1301,台塑         ,20180806,227,25.54,52956,5957.55,3278,368.78,2534533,285134.96,3902,813,0.83,245,18,0
1301,台塑         ,20180807,-41,-4.55,52915,5873.57,35,3.88,2534885,281372.23,2749,2412,0.83,0,41,0
1301,台塑         ,20180808,5,0.56,52920,5927.04,1034,115.81,2535673,283995.38,2953,1959,0.83,5,0,0
1301,台塑         ,20180809,1,0.11,52921,5900.69,-347,-38.69,2535324,282688.63,1201,1550,0.83,27,26,0
1301,台塑         ,20180810,-259,-28.62,52662,5819.15,-1723,-190.39,2533811,279986.12,2397,3652,0.83,9,268,0
1301,台塑         ,20180813,-100,-10.8,52562,5676.7,-1193,-128.84,2532558,273516.26,1547,2700,0.83,0,100,0
1301,台塑         ,20180814,-244,-26.72,52318,5728.82,1600,175.2,2534857,277566.84,4031,1488,0.82,6,250,0
1301,台塑         ,20180815,14,1.53,52332,5704.19,386,42.07,2535154,276331.79,1201,918,0.82,14,0,0
1301,台塑         ,20180816,0,0,52332,5678.02,-187,-20.29,2534988,275046.2,1305,1471,0.82,0,0,0
1301,台塑         ,20180817,0,0,52332,5704.19,774,84.37,2536052,276429.67,2064,1242,0.82,0,0,0
1301,台塑         ,20180820,-110,-11.99,52222,5692.2,886,96.57,2536928,276525.15,4683,3697,0.82,0,110,0
1301,台塑         ,20180821,1,0.11,52223,5692.31,605,65.94,2538023,276644.51,2310,1216,0.82,159,158,0
1301,台塑         ,20180822,0,0,52223,5744.53,375,41.25,2539198,279311.78,1543,369,0.82,0,0,0
1301,台塑         ,20180823,1158,131.43,53381,6058.74,3710,421.08,2544783,288832.87,4147,1477,0.84,1158,0,0.01
1301,台塑         ,20180824,919,103.39,54300,6108.75,1507,169.54,2546692,286502.85,2165,1538,0.85,919,0,0.01
1301,台塑         ,20180827,206,23.38,54506,6186.43,1292,146.64,2547890,289185.52,2019,1028,0.86,206,0,0
1301,台塑         ,20180828,632,72.05,55138,6285.73,1692,192.89,2549728,290668.99,2651,1445,0.87,639,7,0.01
1301,台塑         ,20180829,258,29.28,55396,6287.45,571,64.81,2550627,289496.16,1484,932,0.87,415,157,0
1301,台塑         ,20180830,1105,123.76,56501,6328.11,913,102.26,2551636,285783.23,2219,2315,0.89,1105,0,0.01
1301,台塑         ,20180831,-135,-15.19,56366,6341.18,3511,394.99,2555199,287459.89,6531,2846,0.89,15,150,0
1301,台塑         ,20180903,0,0,56366,6256.63,-1180,-130.98,2554019,283496.11,1133,2344,0.89,0,0,0
1301,台塑         ,20180904,-55,-6.19,56311,6334.99,1503,169.09,2555527,287496.79,2065,506,0.88,0,55,0
1301,台塑         ,20180905,-36,-3.98,56275,6218.39,-1182,-130.61,2554663,282290.26,2091,2889,0.88,0,36,0
1301,台塑         ,20180906,50,5.58,56325,6280.24,135,15.05,2554794,284859.53,1947,1866,0.88,50,0,0
1301,台塑         ,20180907,239,26.69,56564,6306.89,1661,185.2,2558008,285217.89,2497,928,0.89,239,0,0
1301,台塑         ,20180910,962,107.26,57526,6414.15,4415,492.27,2563101,285785.76,5104,974,0.9,962,0,0.01
1301,台塑         ,20180911,247,27.42,57773,6412.8,1313,145.74,2564243,284630.97,3052,2156,0.91,253,6,0
1301,台塑         ,20180912,160,17.76,57933,6430.56,2370,263.07,2566149,284842.54,3081,1214,0.91,160,0,0
1301,台塑         ,20180913,965,108.56,58898,6626.03,3704,416.7,2569850,289108.13,4650,1841,0.93,965,0,0.01
1301,台塑         ,20180914,716,80.19,59614,6676.77,2328,260.74,2572126,288078.11,2632,1072,0.94,716,0,0.01
1301,台塑         ,20180917,171,19.24,59785,6725.81,3008,338.4,2575080,289696.5,3583,752,0.94,171,0,0
1301,台塑         ,20180918,672,75.6,60457,6801.41,3763,423.34,2579075,290145.94,5911,2588,0.95,673,1,0.01
1301,台塑         ,20180919,124,14.01,60581,6845.65,6091,688.28,2585631,292176.3,7133,700,0.95,124,0,0
1301,台塑         ,20180920,422,47.9,61003,6923.84,1214,137.79,2589642,293924.37,3440,2495,0.96,426,4,0
1301,台塑         ,20180921,1142,134.19,62145,7302.04,8549,1004.51,2598125,305279.69,15708,8366,0.98,1182,40,0.01
1301,台塑         ,20180925,52,6.01,62197,7183.75,1673,193.23,2599685,300263.62,6305,4798,0.98,175,123,0
1301,台塑         ,20180926,285,32.63,62482,7154.19,1204,137.86,2600739,297784.62,4639,3870,0.98,285,0,0
1301,台塑         ,20180927,125,14.63,62607,7325.02,7265,850.01,2607898,305124.07,10369,3335,0.98,125,0,0
1301,台塑         ,20180928,507,59.32,53620,6273.54,1166,136.42,2600258,304230.19,6058,5232,0.84,525,18,0
1301,台塑         ,20181001,442,51.94,54062,6352.29,1611,189.29,2601873,305720.08,2302,1129,0.85,442,0,0
1301,台塑         ,20181002,129,14.84,54191,6231.97,-2038,-234.37,2599935,298992.53,2200,4267,0.85,136,7,0
1301,台塑         ,20181003,-47,-5.31,54144,6118.27,612,69.16,2600528,293859.66,3498,2858,0.85,3,50,0
1301,台塑         ,20181004,42,4.75,54186,6123.02,-2211,-249.84,2598232,293600.22,2840,5208,0.85,42,0,0
1301,台塑         ,20181005,-36,-3.96,54150,6010.65,1090,120.99,2598955,288484.01,4072,2762,0.85,167,203,0
1301,台塑         ,20181008,187,20.85,54337,6058.58,-85,-9.48,2598722,289757.5,1695,2115,0.85,187,0,0
1301,台塑         ,20181009,127,14.41,54464,6181.66,687,77.97,2599330,295023.96,1888,1454,0.86,127,0,0
1301,台塑         ,20181011,-377,-38.83,54087,5570.96,-16730,-1723.19,2582920,266040.76,4375,20180,0.85,273,650,0.01
1301,台塑         ,20181012,-44,-4.66,54043,5728.56,26,2.76,2581760,273666.56,5693,5718,0.85,577,621,0.01
1301,台塑         ,20181015,-269,-27.84,53774,5565.61,-7360,-761.76,2575139,266526.89,1286,7439,0.84,114,383,0
1301,台塑         ,20181016,-1250,-130,52524,5462.5,-2836,-294.94,2571677,267454.41,1717,3215,0.83,14,1264,0.01
1301,台塑         ,20181017,201,20.7,52725,5430.68,-5114,-526.74,2566349,264333.95,2138,7183,0.83,211,10,0
1301,台塑         ,20181018,130,13.39,52855,5444.07,-2917,-300.45,2561549,263839.55,1068,4112,0.83,150,20,0
1301,台塑         ,20181019,-209,-21.53,52646,5422.54,-1776,-182.93,2559814,263660.84,2784,4309,0.83,4,213,0
1301,台塑         ,20181022,-89,-9.17,52557,5413.37,-1215,-125.15,2558519,263527.46,813,2019,0.83,3,92,0
1301,台塑         ,20181023,-410,-41.58,52147,5292.92,-2644,-268.37,2555852,259418.98,418,2675,0.82,153,563,0.01
1301,台塑         ,20181024,45,4.55,52192,5271.39,-1181,-119.28,2554718,258026.52,2567,3746,0.82,99,54,0
1301,台塑         ,20181025,-646,-63.66,51546,5082.44,-17,-1.68,2554449,251868.67,4118,3652,0.81,16,662,0.01
1301,台塑         ,20181026,-536,-52.64,51010,5009.18,-818,-80.33,2554182,250820.67,4989,5420,0.8,44,580,0
1301,台塑         ,20181029,-1455,-143.75,49555,4896.03,-1517,-149.88,2552121,252149.55,1955,1955,0.78,1,1456,0.01
1301,台塑         ,20181030,-1522,-150.07,48033,4736.05,581,57.29,2552653,251691.59,5179,3125,0.75,0,1522,0.01
1301,台塑         ,20181031,-563,-56.86,47470,4794.47,-89,-8.99,2552264,257778.66,5333,5038,0.75,37,600,0.01
1301,台塑         ,20181101,-45,-4.57,47425,4813.64,-349,-35.42,2551931,259021,3280,3568,0.75,0,45,0
1301,台塑         ,20181102,-895,-90.42,46530,4699.53,-1790,-180.79,2550139,257564.04,3119,4016,0.73,1,896,0.01
1301,台塑         ,20181105,-189,-19.47,46341,4773.12,393,40.48,2550765,262728.79,4188,3465,0.73,0,189,0
1301,台塑         ,20181106,-647,-66.64,45694,4706.48,-2241,-230.82,2548665,262512.5,3113,4566,0.72,0,647,0.01
1301,台塑         ,20181107,-645,-66.11,45049,4617.52,-3301,-338.35,2545475,260911.19,2799,5252,0.71,24,669,0.01
1301,台塑         ,20181108,-491,-50.08,44558,4544.92,-1647,-167.99,2543885,259476.27,2840,3995,0.7,4,495,0
1301,台塑         ,20181109,-183,-18.48,44375,4481.88,-4557,-460.26,2539210,256460.21,1588,6080,0.7,3,186,0
1301,台塑         ,20181112,-63,-6.36,44312,4475.51,364,36.76,2539784,256518.18,1693,1238,0.7,199,262,0
1301,台塑         ,20181113,-20,-2,44292,4429.2,-757,-75.7,2538707,253870.7,1718,2472,0.7,0,20,0
1301,台塑         ,20181114,-1126,-112.6,43166,4316.6,-952,-95.2,2537772,253777.2,1676,1486,0.68,3,1129,0.01
1301,台塑         ,20181115,3,0.3,43169,4360.07,782,78.98,2537839,256321.74,1631,867,0.68,3,0,0
1301,台塑         ,20181116,-26,-2.59,43143,4357.44,179,18.08,2537989,256336.89,2659,2483,0.68,6,32,0
1301,台塑         ,20181119,126,12.85,43269,4413.44,2176,221.95,2540102,259090.4,4554,2567,0.68,126,0,0
1301,台塑         ,20181120,-196,-19.66,43073,4328.84,209,21,2540182,255288.29,2679,2335,0.68,135,331,0
1301,台塑         ,20181121,-557,-55.59,42516,4243.1,-1376,-137.32,2538390,253331.32,2248,3180,0.67,6,563,0
1301,台塑         ,20181122,-374,-37.77,42142,4256.34,411,41.51,2538811,256419.91,1619,837,0.66,9,383,0
1301,台塑         ,20181123,-81,-8.14,42061,4227.13,285,28.64,2539071,255176.64,2411,2057,0.66,8,89,0
1301,台塑         ,20181126,0,0,42061,4248.16,1075,108.58,2540166,256556.77,3896,2814,0.66,0,0,0
1301,台塑         ,20181127,-244,-24.16,41817,4139.88,-3536,-350.06,2536525,251115.98,1593,4977,0.66,0,244,0
1301,台塑         ,20181128,-368,-36.78,41449,4144.9,706,70.6,2537080,253708,3916,3116,0.65,20,388,0
1301,台塑         ,20181129,-68,-6.77,41381,4117.41,1780,177.11,2538860,252616.57,5370,3946,0.65,13,81,0
1301,台塑         ,20181130,-7,-0.7,41374,4137.4,-150,-15,2537436,253743.6,7267,7519,0.65,130,137,0
1301,台塑         ,20181203,5,0.51,41379,4220.66,-205,-20.91,2537251,258799.6,2958,3229,0.65,61,56,0
1301,台塑         ,20181204,-112,-11.37,41267,4188.6,-1777,-180.37,2535476,257350.81,3638,5308,0.65,15,127,0
1301,台塑         ,20181205,-4,-0.4,41263,4167.56,-1780,-179.78,2534364,255970.76,1391,2437,0.65,16,20,0
1301,台塑         ,20181206,-42,-4.2,41221,4122.1,-3597,-359.7,2530889,253088.9,2147,5580,0.65,12,54,0
1301,台塑         ,20181207,-7,-0.7,41214,4142.01,-815,-81.91,2529927,254257.66,1616,2574,0.65,12,19,0
1301,台塑         ,20181210,6,0.61,41220,4101.39,-2460,-244.77,2527261,251462.47,1211,3701,0.65,6,0,0
1301,台塑         ,20181211,-45,-4.43,41175,4055.74,-4681,-461.08,2522686,248484.57,2129,6714,0.65,5,50,0
1301,台塑         ,20181212,-211,-20.89,40964,4055.44,-3014,-298.39,2519359,249416.54,2944,6059,0.64,1,212,0
1301,台塑         ,20181213,-122,-12.09,40842,4047.44,-1453,-143.99,2517558,249490,3160,4938,0.64,0,122,0
1301,台塑         ,20181214,195,19.34,41037,4070.87,-1038,-102.97,2516399,249626.78,3309,4592,0.64,200,5,0
1301,台塑         ,20181217,-187,-18.57,40850,4056.41,-725,-71.99,2515552,249794.31,2324,2868,0.64,0,187,0
1301,台塑         ,20181218,295,28.91,41145,4032.21,-1753,-171.79,2513815,246353.87,3071,5206,0.65,583,288,0.01
1301,台塑         ,20181219,-166,-16.48,40979,4069.21,2167,215.18,2515806,249819.54,3980,1678,0.64,0,166,0
1301,台塑         ,20181220,509,50.7,41488,4132.2,-432,-43.03,2517969,250789.71,2655,3585,0.65,509,0,0
1301,台塑         ,20181221,-67,-6.61,41421,4084.11,-476,-46.93,2517497,248225.2,3602,4029,0.65,0,67,0
1301,台塑         ,20181222,3,0.29,41424,4071.98,-174,-17.1,2517323,247452.85,0,137,0.65,3,0,0
1301,台塑         ,20181224,12,1.18,41436,4073.16,-501,-49.25,2516681,247389.74,1376,1896,0.65,12,0,0
1301,台塑         ,20181225,5,0.49,41441,4007.34,-867,-83.84,2516075,243304.45,440,1030,0.65,6,1,0
1301,台塑         ,20181226,-235,-22.63,41206,3968.14,-615,-59.22,2515329,242226.18,561,751,0.65,18,253,0
1301,台塑         ,20181227,78,7.63,41284,4037.58,794,77.65,2516066,246071.25,2406,1761,0.65,265,187,0
1301,台塑         ,20181228,-1,-0.1,50755,5126.26,664,67.06,2526711,255197.81,3730,3027,0.8,0,1,0
1301,台塑         ,20190102,-421,-41.09,50334,4912.6,-3189,-311.25,2523522,246295.75,1593,4273,0.79,13,434,0
1301,台塑         ,20190103,-319,-30.62,50015,4801.44,-3239,-310.94,2520062,241925.95,2471,5606,0.79,62,381,0
1301,台塑         ,20190104,-1088,-103.69,48927,4662.74,-1551,-147.81,2518486,240011.72,3508,4764,0.77,12,1100,0.01
1301,台塑         ,20190107,-461,-45.87,48466,4822.37,2496,248.35,2520680,250807.66,5584,2601,0.76,18,479,0
1301,台塑         ,20190108,-97,-9.89,48369,4933.64,1904,194.21,2522633,257308.57,4715,2550,0.76,65,162,0
1301,台塑         ,20190109,55,5.64,48424,4963.46,-1471,-150.78,2521375,258440.94,6625,8711,0.76,536,481,0.01
1301,台塑         ,20190110,514,51.66,48938,4918.27,-7936,-797.57,2513661,252622.93,2535,11144,0.77,574,60,0
1301,台塑         ,20190111,82,8.32,49020,4975.53,-1805,-183.21,2511821,254949.83,3344,5305,0.77,91,9,0
1301,台塑         ,20190114,-6,-0.61,49014,4974.92,-1910,-193.87,2509911,254755.97,1116,3093,0.77,22,28,0
1301,台塑         ,20190115,-17,-1.71,48997,4973.2,-1157,-117.44,2515792,255352.89,3101,4563,0.77,46,63,0
1301,台塑         ,20190116,54,5.45,49051,4954.15,-1686,-170.29,2513897,253903.6,1805,3727,0.77,152,98,0
1301,台塑         ,20190117,20,2.03,49071,4980.71,-440,-44.66,2513193,255089.09,3540,4077,0.77,20,0,0
1301,台塑         ,20190118,19,1.95,49090,5031.73,2641,270.7,2515834,257872.98,4033,1732,0.77,20,1,0
1301,台塑         ,20190121,-309,-31.67,48781,5000.05,-890,-91.23,2515077,257795.39,1825,2258,0.77,20,329,0
1301,台塑         ,20190122,25,2.58,48806,5027.02,74,7.62,2515391,259085.27,1945,1892,0.77,36,11,0
1301,台塑         ,20190123,-82,-8.28,48724,4921.12,-1916,-193.52,2513451,253858.55,1240,3033,0.77,76,158,0
1301,台塑         ,20190124,134,13.4,48858,4885.8,-1408,-140.8,2511940,251194,2560,4583,0.77,134,0,0
1301,台塑         ,20190125,223,22.75,49081,5006.26,911,92.92,2512839,256309.58,4823,4206,0.77,223,0,0
1301,台塑         ,20190128,44,4.47,49125,4986.19,-2091,-212.24,2510753,254841.43,2556,5014,0.77,59,15,0
1301,台塑         ,20190129,-132,-13.33,48993,4948.29,-1599,-161.5,2509026,253411.63,3984,5572,0.77,48,180,0
1301,台塑         ,20190130,-64,-6.53,48929,4990.76,-995,-101.49,2504769,255486.44,8244,9375,0.77,46,110,0
1301,台塑         ,20190211,-1070,-107,47859,4785.9,-2329,-232.9,2502393,250239.3,5556,6981,0.75,6,1076,0.01
1301,台塑         ,20190212,-871,-88.41,46988,4769.28,-1453,-147.48,2500614,253812.32,2317,2964,0.74,0,871,0.01
1301,台塑         ,20190213,0,0,46988,4769.28,-1093,-110.94,2499450,253694.18,1990,3532,0.74,3,3,0
1301,台塑         ,20190214,52,5.28,47040,4774.56,-1462,-148.39,2497993,253546.29,1622,3195,0.74,52,0,0
1301,台塑         ,20190215,0,0,47040,4774.56,-2561,-259.94,2495107,253253.36,1934,4555,0.74,0,0,0
1301,台塑         ,20190218,52,5.33,47092,4826.93,1094,112.14,2496088,255849.02,2991,2059,0.74,52,0,0
1301,台塑         ,20190219,-60,-6.15,47032,4820.78,-655,-67.14,2495433,255781.88,1388,2107,0.74,0,60,0
1301,台塑         ,20190220,-150,-15.45,46882,4828.85,-689,-70.97,2494572,256940.92,2894,3538,0.74,0,150,0
1301,台塑         ,20190221,-12,-1.24,46870,4851.05,-1571,-162.6,2493006,258026.12,2299,4040,0.74,13,25,0
1301,台塑         ,20190222,10,1.04,46880,4875.52,320,33.28,2493326,259305.9,3469,3166,0.74,60,50,0
1301,台塑         ,20190225,14,1.43,46894,4853.53,-1445,-149.56,2492116,257934.01,1982,3610,0.74,20,6,0
1301,台塑         ,20190226,-109,-11.23,46785,4818.85,-1258,-129.57,2491151,256588.55,3725,4938,0.73,13,122,0
1301,台塑         ,20190227,-2,-0.21,46783,4795.26,-3050,-312.63,2486627,254879.27,2809,5771,0.73,0,2,0
1301,台塑         ,20190304,-126,-12.8,46657,4735.69,-5622,-570.63,2481000,251821.5,2917,8451,0.73,0,126,0
1301,台塑         ,20190305,0,0,46657,4759.01,-3756,-383.11,2477809,252736.52,685,4311,0.73,0,0,0
1301,台塑         ,20190306,0,0,46657,4805.67,-117,-12.05,2478372,255272.32,5659,5290,0.73,0,0,0
1301,台塑         ,20190307,92,9.71,46749,4932.02,848,89.46,2480007,261640.74,4117,2574,0.73,92,0,0
1301,台塑         ,20190308,0,0,46749,4861.9,-5800,-603.2,2474145,257311.08,1291,7135,0.73,0,0,0
1301,台塑         ,20190311,0,0,46749,4815.15,-3046,-313.74,2469074,254314.62,1005,4149,0.73,0,0,0
1301,台塑         ,20190312,149,15.57,46898,4900.84,-486,-50.79,2468582,257966.82,2160,2800,0.74,149,0,0
1301,台塑         ,20190313,320,33.44,47218,4934.28,-727,-75.97,2468238,257930.87,374,1436,0.74,416,96,0
1301,台塑         ,20190314,-2,-0.21,47216,4910.46,-1559,-162.14,2466934,256561.14,482,2068,0.74,0,2,0
1301,台塑         ,20190315,2553,269.34,49769,5250.63,2024,213.53,2468922,260471.27,4895,5540,0.78,2687,134,0.02
1301,台塑         ,20190318,808,86.05,50577,5386.45,1096,116.72,2470029,263058.09,1814,1548,0.79,820,12,0.01
1301,台塑         ,20190319,-243,-25.76,50334,5335.4,-454,-48.12,2469519,261769.01,798,1065,0.79,0,243,0
1301,台塑         ,20190320,15,1.6,50349,5362.17,1543,164.33,2471127,263175.03,2606,1013,0.79,15,0,0
1301,台塑         ,20190321,97,10.33,50446,5372.5,348,37.06,2471784,263245,1216,983,0.79,97,0,0
1301,台塑         ,20190322,357,38.36,50803,5461.32,2838,305.09,2474568,266016.06,3283,856,0.8,363,6,0
1301,台塑         ,20190325,-3,-0.32,50800,5410.2,2798,297.99,2477378,263840.76,4163,1350,0.8,0,3,0
1301,台塑         ,20190326,6,0.65,50806,5487.05,1146,123.77,2478374,267664.39,1619,734,0.8,6,0,0
1301,台塑         ,20190327,315,34.34,51121,5572.19,657,71.61,2478546,270161.51,2244,1872,0.8,318,3,0
1301,台塑         ,20190328,255,27.8,51376,5599.98,1623,176.91,2480252,270347.47,2852,1401,0.81,301,46,0
1301,台塑         ,20190329,9,0.99,50500,5529.75,114,12.48,2479508,271506.13,5078,4945,0.79,9,0,0
1301,台塑         ,20190401,-83,-8.9,50417,5419.83,-1825,-196.19,2477683,266350.92,1963,3733,0.79,0,83,0
1301,台塑         ,20190402,-1,-0.11,50416,5444.93,860,92.88,2480242,267866.14,2121,1248,0.79,7,8,0
1301,台塑         ,20190403,-96,-10.37,50320,5434.56,-682,-73.66,2479690,267806.52,826,1267,0.79,0,96,0
1301,台塑         ,20190408,0,0,50320,5434.56,-1283,-138.56,2478501,267678.11,1549,3568,0.79,0,0,0
1301,台塑         ,20190409,39,4.27,50359,5514.31,332,36.35,2479018,271452.47,1841,1966,0.79,39,0,0
1301,台塑         ,20190410,0,0,50359,5539.49,588,64.68,2479612,272757.32,2171,2122,0.79,0,0,0
1301,台塑         ,20190411,1,0.11,50360,5539.6,-946,-104.06,2478775,272665.25,1040,2265,0.79,10,9,0
1301,台塑         ,20190412,-73,-7.92,50287,5456.14,-2534,-274.94,2476344,268683.32,1530,4033,0.79,0,73,0
1301,台塑         ,20190415,-189,-20.51,50098,5435.63,-395,-42.86,2475849,268629.62,1209,1425,0.79,0,189,0
1301,台塑         ,20190416,-116,-12.64,49982,5448.04,-376,-40.98,2475729,269854.46,2605,2872,0.79,0,116,0
1301,台塑         ,20190417,-842,-91.78,49140,5356.26,-194,-21.15,2476424,269930.22,3937,3492,0.77,0,842,0.01
1301,台塑         ,20190418,-1099,-118.69,48041,5188.43,-967,-104.44,2475451,267348.71,3886,3634,0.75,0,1099,0.01
1301,台塑         ,20190419,-67,-7.27,47974,5205.18,361,39.17,2475820,268626.47,987,325,0.75,0,67,0
1301,台塑         ,20190422,-11,-1.16,47963,5203.99,-237,-25.71,2475583,268600.76,125,250,0.75,0,11,0
1301,台塑         ,20190423,-44,-4.82,47919,5247.13,414,45.33,2475992,271121.12,1471,830,0.75,0,44,0
1301,台塑         ,20190424,100,10.95,48019,5258.08,-493,-53.98,2475520,271069.44,1539,1855,0.75,100,0,0
1301,台塑         ,20190425,0,0,48019,5306.1,92,10.17,2475640,273558.22,1435,1456,0.75,0,0,0
1301,台塑         ,20190426,149,16.61,48168,5370.73,-342,-38.13,2475300,275995.95,1077,1561,0.76,156,7,0
1301,台塑         ,20190429,71,7.99,48239,5426.89,437,49.16,2475824,278530.2,1739,1371,0.76,76,5,0
1301,台塑         ,20190430,-3,-0.34,48236,5402.43,-1442,-161.5,2473148,276992.58,2277,4133,0.76,0,3,0
1301,台塑         ,20190502,-1,-0.11,48235,5402.32,2955,330.96,2476506,277368.67,2420,856,0.76,7,8,0
1301,台塑         ,20190503,48,5.33,48283,5359.41,-2677,-297.15,2473809,274592.8,1140,3992,0.76,57,9,0
1301,台塑         ,20190506,30,3.33,48313,5362.74,-3410,-378.51,2470833,274262.46,1438,4642,0.76,30,0,0
1301,台塑         ,20190507,-72,-8,48241,5330.63,-1104,-121.99,2469776,272910.25,1487,2550,0.76,41,113,0
1301,台塑         ,20190508,-10,-1.15,48231,5281.29,-2631,-288.09,2467200,270158.4,1527,4300,0.76,0,10,0
1301,台塑         ,20190509,-5,-0.54,48226,5232.52,-4154,-450.71,2462906,267225.3,2859,6739,0.76,0,5,0
1301,台塑         ,20190510,0,0,48226,5280.75,2144,234.77,2465038,269921.66,3567,1466,0.76,0,0,0
1301,台塑         ,20190513,15,1.63,48241,5234.15,-2421,-262.68,2464481,267396.19,1086,3624,0.76,15,0,0
1301,台塑         ,20190514,0,0,48241,5210.03,-1906,-205.85,2462585,265959.18,2003,4497,0.76,0,0,0
1301,台塑         ,20190515,-10,-1.09,48231,5257.18,-355,-38.7,2461845,268341.11,2463,3081,0.76,0,10,0
1301,台塑         ,20190516,135,14.65,48366,5247.71,-1744,-189.22,2460101,266920.96,1771,3626,0.76,135,0,0
1301,台塑         ,20190517,318,34.5,48684,5282.21,-259,-28.1,2459491,266854.77,1315,1906,0.76,320,2,0
1301,台塑         ,20190520,143,15.73,48827,5370.97,1421,156.31,2460907,270699.77,2416,1868,0.77,148,5,0
1301,台塑         ,20190521,77,8.55,48904,5428.34,3073,341.1,2463999,273503.89,4055,1452,0.77,77,0,0
1301,台塑         ,20190522,73,8.03,48977,5387.47,-1279,-140.69,2462739,270901.29,1474,2923,0.77,76,3,0
1301,台塑         ,20190523,620,67.58,49597,5406.07,644,70.2,2463383,268508.75,2228,2187,0.78,642,22,0.01
1301,台塑         ,20190524,2,0.22,49599,5381.49,-233,-25.28,2463150,267251.78,2388,2665,0.78,12,10,0
1301,台塑         ,20190527,-44,-4.82,49555,5426.27,289,31.65,2463439,269746.57,1236,895,0.78,0,44,0
1301,台塑         ,20190528,63,6.93,49618,5457.98,1198,131.78,2464521,271097.31,11018,9910,0.78,92,29,0
1301,台塑         ,20190529,14,1.53,49632,5409.89,400,43.6,2464921,268676.39,2495,2238,0.78,17,3,0
1301,台塑         ,20190530,0,0,49632,5459.52,1842,202.62,2466763,271343.93,4504,2793,0.78,0,0,0
1301,台塑         ,20190531,73,8.07,49705,5492.4,1165,128.73,2464119,272285.15,3894,2892,0.78,87,14,0
1301,台塑         ,20190603,0,0,49705,5442.7,198,21.68,2463734,269778.87,1853,1684,0.78,0,0,0
1301,台塑         ,20190604,-305,-33.25,49400,5384.6,-1078,-117.5,2462179,268377.51,2676,3539,0.78,0,305,0
1301,台塑         ,20190605,0,0,49400,5434,1035,113.85,2462282,270851.02,2184,1160,0.78,0,0,0
1301,台塑         ,20190606,-135,-14.85,49265,5419.15,670,73.7,2461916,270810.76,2078,1422,0.77,0,135,0
1301,台塑         ,20190610,0,0,49265,5468.42,2391,265.4,2463269,273422.86,3797,1579,0.77,0,0,0
1301,台塑         ,20190611,0,0,49265,5493.05,574,64,2460263,274319.32,2794,2287,0.77,0,0,0
1301,台塑         ,20190612,202,22.59,49467,5540.3,311,34.83,2456072,275080.06,2273,2301,0.78,365,163,0
1301,台塑         ,20190613,17,1.87,49484,5542.21,-533,-59.7,2452823,274716.18,1526,2165,0.78,17,0,0
1301,台塑         ,20190614,267,29.9,49751,5572.11,351,39.31,2449559,274350.61,1662,1679,0.78,267,0,0
1301,台塑         ,20190617,-62,-7.02,49689,5590.01,1474,165.83,2448830,275493.38,3086,1671,0.78,10,72,0
1301,台塑         ,20190618,274,30.83,49963,5620.84,1357,152.66,2447915,275390.44,2433,1410,0.78,294,20,0
1301,台塑         ,20190619,-157,-17.74,49806,5628.08,1860,210.18,2452216,277100.41,3852,2799,0.78,9,166,0
1301,台塑         ,20190620,-125,-14.06,49681,5589.11,3803,427.84,2455013,276188.96,6796,3087,0.78,23,148,0
1301,台塑         ,20190621,-320,-36.16,49361,5577.79,2237,252.78,2457266,277671.06,10215,7779,0.78,23,343,0
1301,台塑         ,20190624,128,14.61,49489,5666.49,2803,320.94,2457738,281411,3636,1027,0.78,128,0,0
1301,台塑         ,20190625,0,0,49489,5666.49,817,93.55,2458570,281506.27,4224,3568,0.78,0,0,0
1301,台塑         ,20190626,26,2.98,49515,5669.47,1702,194.88,2460332,281708.01,3217,1674,0.78,26,0,0
1301,台塑         ,20190627,24,2.75,49539,5672.22,3001,343.61,2463295,282047.28,4986,2047,0.78,24,0,0
1301,台塑         ,20190628,-1,-0.11,68597,7854.36,769,88.05,2486051,284652.84,3971,3339,1.08,0,1,0
1301,台塑         ,20190701,-150,-17.25,68447,7871.41,2929,336.84,2488987,286233.51,3810,1932,1.08,1,151,0
1301,台塑         ,20190702,-805,-84.93,67642,7136.23,-4721,-498.07,2477089,261332.89,10374,12550,1.06,0,805,0.01
1301,台塑         ,20190703,-662,-69.51,66980,7032.9,-853,-89.57,2476305,260012.03,1422,1466,1.05,0,662,0.01
1301,台塑         ,20190704,-204,-21.3,66776,6978.09,-342,-35.74,2476353,258778.89,1101,1502,1.05,0,204,0
1301,台塑         ,20190705,-213,-22.26,66563,6955.83,106,11.08,2476459,258789.97,956,639,1.05,9,222,0
1301,台塑         ,20190708,-423,-43.99,66140,6878.56,632,65.73,2477860,257697.44,2683,1607,1.04,0,423,0
1301,台塑         ,20190709,-2515,-256.53,63625,6489.75,638,65.08,2478498,252806.8,4444,1253,1,131,2646,0.02
1301,台塑         ,20190710,-456,-46.97,63169,6506.41,986,101.56,2479914,255431.14,2161,1104,0.99,83,539,0
1301,台塑         ,20190711,-326,-33.42,62843,6441.41,406,41.62,2480515,254252.79,2408,1582,0.99,16,342,0
1301,台塑         ,20190712,-2,-0.21,62841,6535.46,1220,126.88,2481735,258100.44,4768,3476,0.99,0,2,0
1301,台塑         ,20190715,0,0,62841,6629.73,2532,267.13,2484277,262091.22,7924,5336,0.99,0,0,0
1301,台塑         ,20190716,34,3.54,62875,6539,-654,-68.02,2485001,258440.1,1475,2126,0.99,34,0,0
1301,台塑         ,20190717,-594,-60.59,62281,6352.66,-3186,-324.97,2482293,253193.89,5963,8495,0.98,4,598,0
1301,台塑         ,20190718,-56,-5.72,62225,6315.84,-1251,-126.98,2483065,252031.1,1211,2401,0.98,18,74,0
1301,台塑         ,20190719,-11,-1.11,62214,6283.61,-745,-75.25,2482320,250714.32,3142,3886,0.98,71,82,0
1301,台塑         ,20190722,-250,-25.5,61964,6320.33,1217,124.13,2483537,253320.77,4881,3376,0.97,17,267,0
1301,台塑         ,20190723,28,2.9,61992,6416.17,793,82.08,2484314,257126.5,4016,3220,0.97,28,0,0
1301,台塑         ,20190724,-356,-35.96,61636,6225.24,-2995,-302.5,2480120,250492.12,1152,3339,0.97,9,365,0
1301,台塑         ,20190725,-411,-41.72,61225,6214.34,309,31.36,2480429,251763.54,3642,1880,0.96,63,474,0
1301,台塑         ,20190726,2,0.2,61227,6183.93,-1123,-113.42,2479528,250432.33,1375,2544,0.96,2,0,0
1301,台塑         ,20190729,-431,-43.53,60796,6140.4,-1286,-129.89,2478241,250302.34,1898,2116,0.96,28,459,0
1301,台塑         ,20190730,34,3.45,60830,6174.25,1054,106.98,2479296,251648.54,2332,1212,0.96,34,0,0
1301,台塑         ,20190731,-11,-1.11,60819,6112.31,-440,-44.22,2480137,249253.77,8294,8298,0.96,28,39,0
1301,台塑         ,20190801,23,2.29,60842,6053.78,-4363,-434.12,2476008,246362.8,1229,5608,0.96,23,0,0
1301,台塑         ,20190802,-123,-11.99,60719,5920.1,-5448,-531.18,2470760,240899.1,2239,7495,0.95,0,123,0
1301,台塑         ,20190805,7,0.68,60726,5860.06,333,32.13,2471204,238471.19,5611,5174,0.95,43,36,0
1301,台塑         ,20190806,48,4.6,60774,5822.15,-1056,-101.16,2469026,236532.69,2840,4062,0.95,58,10,0
1301,台塑         ,20190807,-223,-21.25,60551,5770.51,-2617,-249.4,2464898,234904.78,1747,3818,0.95,34,257,0
1301,台塑         ,20190808,-287,-27.3,60264,5737.13,-808,-76.92,2464039,234576.51,1459,1952,0.95,14,301,0
1301,台塑         ,20190812,-18,-1.69,60246,5657.1,-1275,-119.72,2463030,231278.52,1831,2862,0.95,11,29,0
1301,台塑         ,20190813,-1076,-99.56,59170,5473.23,632,58.46,2463827,227904,5087,3396,0.93,36,1112,0.01
1301,台塑         ,20190814,3,0.28,59173,5538.59,-198,-18.53,2463836,230615.05,2960,3025,0.93,3,0,0
1301,台塑         ,20190815,-501,-45.24,58672,5298.08,-3911,-353.16,2459750,222115.43,2792,6373,0.92,30,531,0
1301,台塑         ,20190816,-830,-75.61,57842,5269.41,-3761,-342.63,2456227,223762.28,3095,6264,0.91,27,857,0.01
1301,台塑         ,20190819,34,3.13,57876,5324.59,-1291,-118.77,2455436,225900.11,2307,3653,0.91,35,1,0
1301,台塑         ,20190820,0,0,57876,5388.26,-978,-91.05,2455422,228599.79,2104,2958,0.91,6,6,0
1301,台塑         ,20190821,-6,-0.56,57870,5376.12,-2458,-228.35,2453243,227906.27,1410,3583,0.91,17,23,0
1301,台塑         ,20190822,-16,-1.48,57854,5339.92,-2023,-186.72,2451619,226284.43,1990,3827,0.91,0,16,0
1301,台塑         ,20190823,22,2.05,57876,5405.62,-668,-62.39,2450081,228837.57,1154,1744,0.91,22,0,0
1301,台塑         ,20190826,-24,-2.2,57852,5305.03,-3442,-315.63,2447191,224407.41,1388,4254,0.91,0,24,0
1301,台塑         ,20190827,-15,-1.36,57837,5240.03,-4190,-379.61,2443021,221337.7,8757,12976,0.91,18,33,0
1301,台塑         ,20190828,-157,-14.37,57680,5277.72,-1132,-103.58,2442012,223444.1,1883,2804,0.91,51,208,0
1301,台塑         ,20190829,30,2.74,57710,5274.69,-1268,-115.9,2440714,223081.26,2049,3377,0.91,30,0,0
1301,台塑         ,20190830,834,78.48,58544,5508.99,1637,154.04,2442302,229820.62,4508,3801,0.92,877,43,0.01
1301,台塑         ,20190902,623,58.56,59167,5561.7,-349,-32.81,2441953,229543.58,1153,2506,0.93,623,0,0
1301,台塑         ,20190903,252,23.61,59419,5567.56,-334,-31.3,2445131,229108.77,1860,2610,0.93,252,0,0
1301,台塑         ,20190904,13,1.23,59432,5628.21,-648,-61.37,2444443,231488.75,4219,5473,0.93,13,0,0
1301,台塑         ,20190905,433,41.57,59865,5747.04,549,52.7,2445032,234723.07,3352,3306,0.94,449,16,0
1301,台塑         ,20190906,5,0.48,59870,5699.62,-1106,-105.29,2443359,232607.78,2440,3587,0.94,50,45,0
1301,台塑         ,20190909,150,14.28,60020,5713.9,-244,-23.23,2443343,232606.25,993,1368,0.94,150,0,0
1301,台塑         ,20190910,-15,-1.43,60005,5730.48,378,36.1,2444525,233452.14,2239,1567,0.94,0,15,0
1301,台塑         ,20190911,70,6.68,60075,5731.16,756,72.12,2446289,233375.97,4119,1479,0.94,85,15,0
1301,台塑         ,20190912,60,5.77,60135,5778.97,1232,118.4,2448351,235286.53,3264,1260,0.94,60,0,0
1301,台塑         ,20190916,1698,166.41,61833,6059.63,666,65.27,2449331,240034.44,3806,4305,0.97,1702,4,0.01
1301,台塑         ,20190917,333,32.57,62166,6079.83,1797,175.75,2450707,239679.14,3138,1555,0.98,333,0,0
1301,台塑         ,20190918,68,6.63,62234,6074.04,1320,128.83,2453190,239431.34,4795,2380,0.98,85,17,0
1301,台塑         ,20190919,40,3.89,62274,6059.26,-209,-20.34,2456002,238968.99,1283,1279,0.98,68,28,0
1301,台塑         ,20190920,352,34.36,62626,6112.3,1112,108.53,2457558,239857.66,7359,6154,0.98,415,63,0
1301,台塑         ,20190923,27,2.61,62653,6064.81,-473,-45.79,2459790,238107.67,2821,3056,0.98,27,0,0
1301,台塑         ,20190924,-519,-50.19,62134,6008.36,1147,110.91,2465346,238398.96,3321,1295,0.98,271,790,0.01
1301,台塑         ,20190925,9,0.86,62143,5934.66,-82,-7.83,2468398,235732.01,2654,2434,0.98,240,231,0
1301,台塑         ,20190926,138,13.28,62281,5991.43,1066,102.55,2470040,237617.85,3150,1935,0.98,143,5,0
1301,台塑         ,20190927,-7,-0.66,40321,3810.33,-1180,-111.51,2447002,231241.69,1587,2665,0.63,0,7,0
1301,台塑         ,20191001,-2,-0.23,40319,3822.24,617,58.49,2447417,232015.13,3931,3279,0.63,3,5,0
1301,台塑         ,20191002,14,1.31,40333,3783.24,-1879,-176.25,2445171,229357.04,1817,3577,0.63,19,5,0
1301,台塑         ,20191003,-43,-3.98,40290,3751,-1300,-121.03,2443891,227526.25,1746,3003,0.63,9,52,0
1301,台塑         ,20191004,-193,-18.01,40097,3741.05,-172,-16.05,2443757,228002.53,2135,2096,0.63,0,193,0
1301,台塑         ,20191007,-5,-0.47,40092,3772.66,-1013,-95.32,2442913,229878.11,391,1230,0.63,0,5,0
1301,台塑         ,20191008,-201,-18.95,39891,3761.72,-295,-27.82,2442792,230355.29,2183,2207,0.63,0,201,0
1301,台塑         ,20191009,-22,-2.01,39869,3711.8,-845,-78.67,2442503,227397.03,1454,1741,0.63,0,22,0
1301,台塑         ,20191014,-203,-18.94,39666,3700.84,-1359,-126.79,2441148,227759.11,5192,6343,0.62,0,203,0
1301,台塑         ,20191015,0,0,39666,3752.4,1365,129.13,2443469,231152.17,3980,1659,0.62,0,0,0
1301,台塑         ,20191016,-10,-0.98,39656,3803.01,2429,232.94,2446984,234665.77,5073,2172,0.62,23,33,0
1301,台塑         ,20191017,101,9.71,39757,3840.53,2817,272.12,2450797,236746.99,4712,1840,0.62,101,0,0
1301,台塑         ,20191018,22,2.14,39779,3818.78,695,66.72,2451756,235368.58,2862,2201,0.62,22,0,0
1301,台塑         ,20191021,-107,-10.19,39672,3784.71,568,54.19,2452291,233948.56,3191,2548,0.62,0,107,0
1301,台塑         ,20191022,20,1.94,39692,3842.19,2042,197.67,2454379,237583.89,2719,655,0.62,20,0,0
1301,台塑         ,20191023,-30,-2.91,39662,3799.62,-538,-51.54,2454716,235161.79,2264,2013,0.62,5,35,0
1301,台塑         ,20191024,59,5.75,39721,3872.8,3237,315.61,2458397,239693.71,5074,1452,0.62,158,99,0
1301,台塑         ,20191025,21,2.08,39742,3866.9,-278,-27.05,2458139,239176.92,1294,1573,0.62,30,9,0
1301,台塑         ,20191028,245,23.81,39987,3886.74,-163,-15.84,2458002,238917.79,1228,1615,0.63,245,0,0
1301,台塑         ,20191029,-6,-0.59,39981,3906.14,1848,180.55,2459852,240327.54,2847,1006,0.63,0,6,0
1301,台塑         ,20191030,89,8.75,40070,3938.88,1794,176.35,2461665,241981.67,4640,2916,0.63,89,0,0
1301,台塑         ,20191031,-14,-1.37,40056,3917.48,-162,-15.84,2461582,240742.72,4300,4404,0.63,0,14,0
1301,台塑         ,20191101,7,0.69,40063,3930.18,822,80.64,2462441,241565.46,1414,588,0.63,7,0,0
1301,台塑         ,20191104,-540,-53.41,39523,3908.82,2059,203.64,2465041,243792.55,3282,748,0.62,7,547,0
1301,台塑         ,20191105,-377,-37.29,39146,3871.54,1512,149.54,2466019,243889.28,3651,1762,0.61,16,393,0
1301,台塑         ,20191106,60,5.92,39206,3869.63,1458,143.9,2467477,243539.98,2986,1604,0.62,60,0,0
1301,台塑         ,20191107,192,18.85,39398,3868.88,428,42.03,2467971,242354.75,2501,2178,0.62,227,35,0
1301,台塑         ,20191108,170,16.56,39568,3853.92,-1106,-107.72,2467015,240287.26,3019,4301,0.62,170,0,0
1301,台塑         ,20191111,-3,-0.29,39565,3837.8,-80,-7.76,2467057,239304.53,3248,3323,0.62,8,11,0
1301,台塑         ,20191112,-202,-19.57,39363,3814.27,-74,-7.17,2467016,239053.85,1992,1847,0.62,58,260,0
1301,台塑         ,20191113,-284,-27.35,39079,3763.31,-1815,-174.78,2465172,237396.06,1091,2722,0.61,0,284,0
1301,台塑         ,20191114,16,1.55,39095,3776.58,-399,-38.54,2464761,238095.91,1155,1518,0.61,16,0,0
1301,台塑         ,20191115,0,0,39095,3784.4,749,72.5,2465510,238661.37,1862,1112,0.61,0,0,0
1301,台塑         ,20191118,124,12.08,39219,3819.93,267,26.01,2465791,240168.04,1359,1208,0.62,124,0,0
1301,台塑         ,20191119,-35,-3.41,39184,3816.52,1678,163.44,2467532,240337.62,2834,1099,0.62,0,35,0
1301,台塑         ,20191120,43,4.15,39227,3785.41,-696,-67.16,2466996,238065.11,1643,2248,0.62,43,0,0
1301,台塑         ,20191121,105,10.1,39332,3783.74,-1529,-147.09,2465463,237177.54,1041,2608,0.62,113,8,0
1301,台塑         ,20191122,10,0.97,39342,3808.31,-260,-25.17,2465130,238624.58,1939,2089,0.62,25,15,0
1301,台塑         ,20191125,0,0,39342,3816.17,-186,-18.04,2464980,239103.06,1585,1675,0.62,0,0,0
1301,台塑         ,20191126,-314,-30.77,39028,3824.74,4433,434.43,2469374,241998.65,18535,13647,0.61,22,336,0
1301,台塑         ,20191127,-11,-1.08,39017,3839.27,965,94.96,2470065,243054.4,3156,2291,0.61,16,27,0
1301,台塑         ,20191128,-41,-4.06,38976,3831.34,1157,113.73,2471192,242918.17,3049,1845,0.61,7,48,0
1301,台塑         ,20191129,17,1.65,38993,3790.12,884,85.92,2471510,240230.77,4638,3895,0.61,17,0,0
1301,台塑         ,20191202,29,2.84,39022,3828.06,1753,171.97,2473278,242628.57,2504,765,0.61,29,0,0
1301,台塑         ,20191203,1,0.1,39023,3804.74,-213,-20.77,2473050,241122.38,2253,2498,0.61,13,12,0
1301,台塑         ,20191204,-519,-50.6,38504,3754.14,-448,-43.68,2472466,241065.44,1699,1531,0.6,9,528,0
1301,台塑         ,20191205,-143,-13.79,38361,3698,-1258,-121.27,2473942,238488.01,1395,2492,0.6,19,162,0
1301,台塑         ,20191206,-162,-15.75,38199,3712.94,109,10.59,2472150,240292.98,1001,731,0.6,7,169,0
1301,台塑         ,20191209,-87,-8.41,38112,3685.43,340,32.88,2472474,239088.24,3094,2674,0.6,6,93,0
1301,台塑         ,20191210,-159,-15.34,37953,3662.46,-833,-80.38,2471493,238499.07,1982,2656,0.6,4,163,0
1301,台塑         ,20191211,-61,-5.89,37892,3656.58,-365,-35.22,2471167,238467.62,1427,1691,0.6,50,111,0
1301,台塑         ,20191212,0,0,37892,3671.73,2311,223.94,2472965,239630.31,4400,2040,0.6,0,0,0
1301,台塑         ,20191213,-52,-5.03,37840,3662.91,2919,282.56,2474912,239571.48,4182,1962,0.59,0,52,0
1301,台塑         ,20191216,0,0,37840,3662.91,-673,-65.15,2473657,239450,2772,3509,0.59,0,0,0
1301,台塑         ,20191217,23,2.24,37863,3752.22,3682,364.89,2477253,245495.77,5415,1968,0.59,109,86,0
1301,台塑         ,20191218,170,17.25,38033,3860.35,4817,488.93,2482460,251969.69,6972,2489,0.6,170,0,0
1301,台塑         ,20191219,149,14.89,38182,3814.38,-1457,-145.55,2481267,247878.57,2497,4186,0.6,183,34,0
1301,台塑         ,20191220,34,3.43,38216,3859.82,1534,154.93,2482525,250735.03,6798,5344,0.6,44,10,0
1301,台塑         ,20191223,-18,-1.82,38198,3858,1088,109.89,2485995,251085.5,2041,927,0.6,43,61,0
1301,台塑         ,20191224,-20,-2.01,38178,3836.89,386,38.79,2492205,250466.6,942,566,0.6,0,20,0
1301,台塑         ,20191225,0,0,38178,3817.8,332,33.2,2492537,249253.7,363,430,0.6,0,0,0
1301,台塑         ,20191226,-60,-5.99,38118,3804.18,336,33.53,2492698,248771.26,955,482,0.6,0,60,0
1301,台塑         ,20191227,0,0,38118,3849.92,2171,219.27,2494761,251970.86,2111,777,0.6,0,0,0
1301,台塑         ,20191230,-14,-1.4,38104,3806.59,-579,-57.84,2494242,249174.78,1798,2336,0.6,0,14,0
1301,台塑         ,20191231,0,0,35968,3589.61,-640,-63.87,2489484,248450.5,776,1404,0.57,0,0,0
1301,台塑         ,20200102,-306,-30.48,35662,3551.94,-1310,-130.48,2487102,247715.36,453,1440,0.56,0,306,0
1301,台塑         ,20200103,-363,-36.84,35299,3582.85,1503,152.55,2489673,252701.81,3238,1505,0.55,25,388,0
1301,台塑         ,20200106,354,36.11,35653,3636.61,1720,175.44,2491361,254118.82,3008,1585,0.56,354,0,0
1301,台塑         ,20200107,20,2.03,35673,3620.81,633,64.25,2492003,252938.3,4238,3545,0.56,20,0,0
1301,台塑         ,20200108,-129,-12.9,35544,3554.4,-1115,-111.5,2491165,249116.5,2010,2912,0.56,26,155,0
1301,台塑         ,20200109,-26,-2.6,35518,3551.8,-1100,-110,2490172,249017.2,1390,2415,0.56,4,30,0
1301,台塑         ,20200110,-93,-9.28,35425,3535.42,-326,-32.53,2489779,248479.94,775,1042,0.56,0,93,0
1301,台塑         ,20200113,-35,-3.49,35390,3528.38,-511,-50.95,2489782,248231.27,1748,2447,0.56,0,35,0
1301,台塑         ,20200114,-99,-9.78,35291,3486.75,-2942,-290.67,2487380,245753.14,2337,6026,0.55,0,99,0
1301,台塑         ,20200115,-76,-7.46,35215,3468.68,-1437,-141.54,2485852,244856.42,1735,3253,0.55,0,76,0
1301,台塑         ,20200116,17,1.66,35232,3449.21,-986,-96.53,2484893,243271.02,1087,2211,0.55,17,0,0
1301,台塑         ,20200117,-23,-2.28,35209,3485.69,-467,-46.23,2484315,245947.19,1555,2036,0.55,45,68,0
1301,台塑         ,20200120,40,3.96,35249,3489.65,-122,-12.08,2484844,245999.56,1037,1254,0.55,40,0,0
1301,台塑         ,20200130,-393,-36,34856,3192.81,-8222,-753.14,2476746,226869.93,6069,13872,0.55,108,501,0
1301,台塑         ,20200131,-25,-2.34,34831,3253.22,-3167,-295.8,2471862,230871.91,2627,5651,0.55,30,55,0
1301,台塑         ,20200203,89,8.28,34920,3247.56,-1044,-97.09,2470505,229756.97,2785,4206,0.55,89,0,0
1301,台塑         ,20200204,-6,-0.56,34914,3264.46,-1291,-120.71,2469015,230852.9,2399,3661,0.55,0,6,0
1301,台塑         ,20200205,-50,-4.63,34864,3231.89,-762,-70.64,2468102,228793.06,2097,2632,0.55,5,55,0
1301,台塑         ,20200206,78,7.34,34942,3302.02,414,39.12,2468461,233269.56,2554,2260,0.55,78,0,0
1301,台塑         ,20200207,4,0.37,34946,3274.44,-1149,-107.66,2467265,231182.73,1620,2755,0.55,4,0,0
1301,台塑         ,20200210,0,0,34946,3284.92,-55,-5.17,2466978,231895.93,1506,1576,0.55,0,0,0
1301,台塑         ,20200211,-6,-0.56,34940,3273.88,-1143,-107.1,2465908,231055.58,884,2045,0.55,10,16,0
1301,台塑         ,20200212,-80,-7.52,34860,3276.84,-1552,-145.89,2464464,231659.62,966,2619,0.55,0,80,0
1301,台塑         ,20200213,0,0,34860,3304.73,-1272,-120.59,2463019,233494.2,1301,2550,0.55,0,0,0
1301,台塑         ,20200214,0,0,34860,3318.67,-1471,-140.04,2461806,234363.93,1923,3398,0.55,0,0,0
1301,台塑         ,20200217,1,0.09,34861,3304.82,-2031,-192.54,2452369,232484.58,433,2457,0.55,1,0,0
1301,台塑         ,20200218,25,2.37,34886,3307.19,-1330,-126.08,2451120,232366.18,1496,2825,0.55,25,0,0
1301,台塑         ,20200219,4,0.38,34890,3356.42,1427,137.28,2452606,235940.7,2905,1514,0.55,4,0,0
1301,台塑         ,20200220,0,0,34890,3304.08,-2894,-274.06,2450426,232055.34,1271,4315,0.55,0,0,0
1301,台塑         ,20200221,3,0.28,34893,3300.88,-1857,-175.67,2448236,231603.13,1201,3114,0.55,3,0,0
1301,台塑         ,20200224,-18,-1.68,34875,3253.84,-4340,-404.92,2443304,227960.26,1164,5514,0.55,52,70,0
1301,台塑         ,20200225,-44,-4.1,34831,3242.77,-2969,-276.41,2440257,227187.93,2660,5620,0.55,15,59,0
1301,台塑         ,20200226,-11,-1.01,34820,3186.03,-8148,-745.54,2432136,222540.44,1733,9960,0.55,89,100,0
1301,台塑         ,20200227,71,6.46,34891,3175.08,-5040,-458.64,2425152,220688.83,4908,10018,0.55,71,0,0
1301,台塑         ,20200302,68,6.12,34959,3146.31,-4212,-379.08,2420703,217863.27,2748,7306,0.55,71,3,0
1301,台塑         ,20200303,-72,-6.6,34887,3195.65,-475,-43.51,2419920,221664.67,2781,3328,0.55,34,106,0
1301,台塑         ,20200304,-10,-0.93,34877,3226.12,637,58.92,2419996,223849.63,3481,2951,0.55,0,10,0
1301,台塑         ,20200305,-15,-1.4,34862,3252.62,944,88.08,2420806,225861.2,2400,1814,0.55,0,15,0
1301,台塑         ,20200306,-193,-17.64,34669,3168.75,-4173,-381.41,2416639,220880.8,1950,5716,0.54,7,200,0
1301,台塑         ,20200309,-250,-22.33,34419,3073.62,-5876,-524.73,2411085,215309.89,2857,8617,0.54,151,401,0
1301,台塑         ,20200310,29,2.58,34448,3065.87,-2046,-182.09,2409025,214403.23,3018,4854,0.54,29,0,0
1301,台塑         ,20200311,7,0.6,34455,3063.05,-527,-46.85,2408129,214082.67,3638,3812,0.54,7,0,0
1301,台塑         ,20200312,13,1.09,34468,2895.31,-7722,-648.65,2401073,201690.13,3504,11061,0.54,77,64,0
1301,台塑         ,20200313,27,2.18,34495,2780.3,-7381,-594.91,2392781,192858.15,6683,13979,0.54,59,32,0
1301,台塑         ,20200316,1,0.08,34496,2697.59,-4345,-339.78,2389374,186849.05,3460,7270,0.54,24,23,0
1301,台塑         ,20200317,-157,-11.71,34339,2561.69,-2991,-223.13,2385406,177951.29,7596,10442,0.54,180,337,0
1301,台塑         ,20200318,72,5.04,34411,2408.77,-12256,-857.92,2374772,166234.04,6107,16760,0.54,275,203,0
1301,台塑         ,20200319,-608,-40.49,33803,2251.28,-5631,-375.02,2367910,157702.81,7245,12292,0.53,169,777,0.01
1301,台塑         ,20200320,168,11.58,33971,2337.2,-7653,-526.53,2359811,162355,8437,16065,0.53,206,38,0
1301,台塑         ,20200323,107,7.14,34078,2273,-3087,-205.9,2356445,157174.88,5634,9024,0.54,141,34,0
1301,台塑         ,20200324,276,19.46,34354,2421.96,407,28.69,2356764,166151.86,5781,5485,0.54,276,0,0
1301,台塑         ,20200325,662,49.58,35016,2622.7,-785,-58.8,2354816,176375.72,3907,5220,0.55,662,0,0.01
1301,台塑         ,20200326,3,0.2,35019,2594.91,-2478,-183.62,2352497,174320.03,2748,5034,0.55,29,26,0
1301,台塑         ,20200327,5,0.37,35024,2616.29,147,10.98,2352985,175767.98,3937,3273,0.55,7,2,0
1301,台塑         ,20200330,600,45.12,35624,2678.92,976,73.4,2354304,177043.66,4766,4104,0.56,600,0,0
1301,台塑         ,20200331,1176,88.32,45505,3417.43,-1374,-103.19,2364772,177594.38,4009,6423,0.71,1176,0,0.01
1301,台塑         ,20200401,691,51.41,46196,3436.98,-937,-69.71,2364051,175885.39,2430,4057,0.73,691,0,0.01
1301,台塑         ,20200406,689,53.47,46885,3638.28,1669,129.51,2365326,183549.3,9227,8295,0.74,689,0,0.01
1301,台塑         ,20200407,857,68.39,47742,3809.81,-424,-33.84,2367153,188898.81,6133,7421,0.75,857,0,0.01
1301,台塑         ,20200408,673,54.11,48415,3892.57,-1477,-118.75,2365770,190207.91,3485,5439,0.76,1100,427,0.01
1301,台塑         ,20200409,369,29.74,48784,3931.99,-1691,-136.29,2364158,190551.13,2311,4352,0.77,369,0,0
1301,台塑         ,20200410,-62,-5.08,48722,3990.33,-2003,-164.05,2362242,193467.62,1089,2954,0.77,6,68,0
1301,台塑         ,20200413,-7,-0.59,48715,3931.3,-2844,-229.51,2360105,190460.47,634,3372,0.77,6,13,0
1301,台塑         ,20200414,1337,109.9,50052,4114.27,1799,147.88,2360894,194065.49,5451,5043,0.79,1337,0,0.01
1301,台塑         ,20200415,816,67.81,50868,4227.13,-1407,-116.92,2359284,196056.5,2250,4444,0.8,816,0,0.01
1301,台塑         ,20200416,83,6.81,50951,4183.08,-2733,-224.38,2356482,193467.17,3368,6150,0.8,90,7,0
1301,台塑         ,20200417,801,66.64,51752,4305.77,1067,88.77,2357583,196150.91,3763,3526,0.81,802,1,0.01
1301,台塑         ,20200420,-845,-69.63,50907,4194.74,-3056,-251.81,2354600,194019.04,3257,5396,0.8,655,1500,0.02
1301,台塑         ,20200421,-290,-23.24,50617,4054.42,-4762,-381.44,2357982,188874.36,2594,6789,0.8,0,290,0
1301,台塑         ,20200422,-527,-42.27,50090,4017.22,-1882,-150.94,2356618,189000.76,2325,3519,0.79,61,588,0.01
1301,台塑         ,20200423,217,17.45,50307,4044.68,529,42.53,2357213,189519.93,2948,2603,0.79,224,7,0
1301,台塑         ,20200424,-1,-0.08,50306,4024.48,-869,-69.52,2356314,188505.12,1488,2343,0.79,6,7,0
1301,台塑         ,20200427,95,7.79,50401,4132.88,3238,265.52,2359397,193470.55,4548,1560,0.79,108,13,0
1301,台塑         ,20200428,72,5.95,50473,4174.12,1345,111.23,2360775,195236.09,2522,1250,0.79,72,0,0
1301,台塑         ,20200429,122,10.22,50595,4239.86,2692,225.59,2363206,198036.66,3974,1100,0.79,122,0,0
1301,台塑         ,20200430,1146,100.73,51741,4548.03,3996,351.25,2367032,208062.11,6856,4175,0.81,1146,0,0.01
1301,台塑         ,20200504,55,4.7,51796,4428.56,-6180,-528.39,2360456,201818.99,2762,9021,0.81,55,0,0
1301,台塑         ,20200505,-597,-51.26,51199,4392.87,-1279,-109.74,2356654,202200.91,1316,1983,0.8,7,604,0
1301,台塑         ,20200506,-966,-82.4,50233,4284.87,-2584,-220.42,2354052,200800.64,2366,3804,0.79,34,1000,0.01
1301,台塑         ,20200507,-736,-62.78,49497,4222.09,-2268,-193.46,2351931,200619.71,2124,3702,0.78,0,736,0.01
1301,台塑         ,20200508,7,0.6,49504,4277.15,-588,-50.8,2351467,203166.75,1961,2595,0.78,7,0,0
1301,台塑         ,20200511,14,1.23,49518,4332.83,292,25.55,2351010,205713.38,1867,1541,0.78,14,0,0
1301,台塑         ,20200512,0,0,49518,4283.31,-3349,-289.69,2347614,203068.61,1768,5125,0.78,0,0,0
1301,台塑         ,20200513,33,2.81,49551,4216.79,-11073,-942.31,2336949,198874.36,1937,13077,0.78,33,0,0
1301,台塑         ,20200514,-495,-41.33,49056,4096.18,-7950,-663.83,2328922,194464.99,2313,9793,0.77,6,501,0
1301,台塑         ,20200515,-144,-12.04,48912,4089.04,-2848,-238.09,2326074,194459.79,2969,5673,0.77,0,144,0
1301,台塑         ,20200518,796,67.66,49708,4225.18,1729,146.97,2327840,197866.4,4445,3659,0.78,796,0,0.01
1301,台塑         ,20200519,1631,140.59,51339,4425.42,458,39.48,2326939,200582.14,7856,9305,0.81,1631,0,0.01
1301,台塑         ,20200520,124,10.71,51463,4446.4,141,12.18,2328927,201219.29,2723,2580,0.81,124,0,0
1301,台塑         ,20200521,610,52.77,52073,4504.31,-419,-36.24,2326427,201235.94,2872,3913,0.82,610,0,0
1301,台塑         ,20200522,3,0.26,52076,4426.46,-5693,-483.9,2321111,197294.44,1229,6937,0.82,3,0,0
1301,台塑         ,20200525,21,1.74,52097,4391.78,-2181,-183.86,2318970,195489.17,1912,4007,0.82,21,0,0
1301,台塑         ,20200526,635,54.42,52732,4519.13,3732,319.83,2322271,199018.62,5962,2935,0.83,635,0,0
1301,台塑         ,20200527,538,45.84,53270,4538.6,-748,-63.73,2321523,197793.76,2714,4047,0.84,538,0,0
1301,台塑         ,20200528,585,49.02,53855,4513.05,-5363,-449.42,2315865,194069.49,5194,11055,0.85,585,0,0
1301,台塑         ,20200529,744,61.75,54599,4531.72,-8556,-710.15,2306786,191463.24,57200,66758,0.86,767,23,0.01
1301,台塑         ,20200601,-25,-2.1,54574,4573.3,1225,102.66,2308011,193411.32,6612,5446,0.86,0,25,0
1301,台塑         ,20200602,598,50.41,55172,4651,-474,-39.96,2307551,194526.55,2536,3622,0.87,598,0,0
1301,台塑         ,20200603,1234,106.25,56406,4856.56,6533,562.49,2314084,199242.63,6761,2487,0.89,1245,11,0.01
1301,台塑         ,20200604,913,79.25,57319,4975.29,2468,214.22,2316556,201077.06,4188,2583,0.9,913,0,0.01
1301,台塑         ,20200605,536,46.95,57855,5068.1,2302,201.66,2318864,203132.49,3908,2116,0.91,536,0,0
1301,台塑         ,20200608,370,33,58225,5193.67,2484,221.57,2322368,207155.23,3962,2017,0.91,505,135,0.01
1301,台塑         ,20200609,185,16.56,58410,5227.7,837,74.91,2322822,207892.57,2608,2048,0.92,265,80,0
1301,台塑         ,20200610,-40,-3.58,58370,5218.28,275,24.59,2321933,207580.81,3908,3497,0.92,0,40,0
1301,台塑         ,20200611,663,58.34,59033,5194.9,-1236,-108.77,2320057,204165.02,2281,4097,0.93,670,7,0.01
1301,台塑         ,20200612,250,21.6,59283,5122.05,-2335,-201.74,2315015,200017.3,2098,4680,0.93,320,70,0
1301,台塑         ,20200615,818,70.35,60101,5168.69,-3872,-332.99,2307213,198420.32,1715,6225,0.94,818,0,0.01
1301,台塑         ,20200616,-528,-45.43,59573,5129.24,-4177,-359.64,2301933,198196.43,3862,7561,0.94,112,640,0.01
1301,台塑         ,20200617,47,4.05,59620,5139.24,-2536,-218.6,2298095,198095.79,4097,6345,0.94,500,453,0.01
1301,台塑         ,20200618,1018,87.75,60638,5227,-3272,-282.05,2294010,197743.66,2207,6484,0.95,1140,122,0.01
1301,台塑         ,20200619,952,81.68,61590,5284.42,-3620,-310.6,2290388,196515.29,6257,11055,0.97,1223,271,0.01
1301,台塑         ,20200622,489,42.45,62079,5388.46,-600,-52.08,2289572,198734.85,2605,3832,0.98,729,240,0.01
1301,台塑         ,20200623,-1159,-100.72,60920,5293.95,-2187,-190.05,2291389,199121.7,2658,3738,0.96,0,1159,0.01
1301,台塑         ,20200624,104,9.09,61024,5333.5,-617,-53.93,2291115,200243.45,2044,2790,0.96,115,11,0
1301,台塑         ,20200629,-6,-0.52,61018,5284.16,-6043,-523.32,2285267,197904.12,1551,7546,0.96,0,6,0
1301,台塑         ,20200630,14,1.23,66215,5800.43,-2571,-225.22,2286606,200306.69,4926,7936,1.04,14,0,0
1301,台塑         ,20200701,-7,-0.61,66208,5799.82,-3184,-278.92,2275618,199344.14,2460,9438,1.04,0,7,0
1301,台塑         ,20200702,-1611,-135,64597,5413.23,-2095,-175.56,2266675,189947.37,10148,5820,1.01,0,1611,0.01
1301,台塑         ,20200703,-23,-1.94,64574,5443.59,-153,-12.9,2274053,191702.67,1303,1235,1.01,0,23,0
1301,台塑         ,20200706,-129,-10.89,64445,5439.16,435,36.71,2275170,192024.35,4207,3165,1.01,0,129,0
1301,台塑         ,20200707,-8,-0.67,64437,5393.38,-484,-40.51,2282854,191074.88,3160,3524,1.01,0,8,0
1301,台塑         ,20200708,-12,-1,64425,5360.16,-3214,-267.4,2273882,189186.98,2174,5289,1.01,0,12,0
1301,台塑         ,20200709,-48,-3.98,64377,5343.29,-2974,-246.84,2271415,188527.45,808,3421,1.01,0,48,0
1301,台塑         ,20200710,-104,-8.51,64273,5270.39,-3805,-312.01,2268817,186042.99,948,4602,1.01,0,104,0
1301,台塑         ,20200713,-5,-0.41,64268,5269.98,-1457,-119.47,2266716,185870.71,1887,3318,1.01,0,5,0
1301,台塑         ,20200714,-813,-65.85,63455,5139.85,-5344,-432.86,2262125,183232.13,1183,5663,1,0,813,0.01
1301,台塑         ,20200715,-617,-49.59,62838,5052.18,-2549,-204.94,2265488,182145.24,4631,4061,0.99,0,617,0
1301,台塑         ,20200716,-42,-3.4,62796,5086.48,-1807,-146.37,2266259,183566.98,2454,2576,0.99,27,69,0
1301,台塑         ,20200717,-38,-3.08,62758,5083.4,-665,-53.87,2266899,183618.82,875,1490,0.99,0,38,0
1301,台塑         ,20200720,-71,-5.72,62687,5046.3,-1048,-84.36,2269246,182674.3,898,1813,0.98,0,71,0
1301,台塑         ,20200721,-73,-5.88,62614,5040.43,677,54.5,2271223,182833.45,3212,1985,0.98,0,73,0
1301,台塑         ,20200722,-47,-3.78,62567,5036.64,-2947,-237.23,2267919,182567.48,1876,4637,0.98,0,47,0
1301,台塑         ,20200723,-18,-1.44,62549,5010.17,-368,-29.48,2267946,181662.47,1283,1534,0.98,1,19,0
1301,台塑         ,20200724,-33,-2.63,62516,4982.53,-3120,-248.66,2265126,180530.54,1003,3894,0.98,0,33,0
1301,台塑         ,20200727,2,0.17,62518,4882.66,-2723,-212.67,2262714,176717.96,1601,4269,0.98,20,18,0
1301,台塑         ,20200728,-19,-1.47,62499,4831.17,-828,-64,2261748,174833.12,3526,4290,0.98,0,19,0
1301,台塑         ,20200729,-253,-19.71,62246,4848.96,-1704,-132.74,2260623,176102.53,1290,2101,0.98,2,255,0
1301,台塑         ,20200730,-21,-1.65,62225,4884.66,-1417,-111.23,2259087,177338.33,2029,3417,0.98,1,22,0
1301,台塑         ,20200731,-243,-19.08,61982,4865.59,-1820,-142.87,2257286,177196.95,1397,2970,0.97,2,245,0
1301,台塑         ,20200803,-158,-12.23,61824,4785.18,-5064,-391.95,2252134,174315.17,989,5884,0.97,0,158,0
1301,台塑         ,20200804,-524,-40.66,61300,4756.88,-2197,-170.49,2250099,174607.68,1219,2695,0.96,114,638,0.01
1301,台塑         ,20200805,48,3.76,61348,4791.28,-624,-48.73,2249509,175686.65,772,1421,0.96,55,7,0
1301,台塑         ,20200806,77,6.09,61425,4858.72,403,31.88,2249602,177943.52,1707,1428,0.96,81,4,0
1301,台塑         ,20200807,2,0.16,61427,4889.59,-1812,-144.24,2248112,178949.72,1237,3065,0.96,2,0,0
1301,台塑         ,20200810,20,1.62,61447,4983.35,621,50.36,2248664,182366.65,2001,1437,0.97,20,0,0
1301,台塑         ,20200811,242,19.72,61689,5027.65,1505,122.66,2250176,183389.34,3138,1963,0.97,242,0,0
1301,台塑         ,20200812,46,3.71,61735,4982.01,-1228,-99.1,2249362,181523.51,887,1901,0.97,46,0,0
1301,台塑         ,20200813,87,7.04,61822,5001.4,435,35.19,2249984,182023.71,1406,1067,0.97,87,0,0
1301,台塑         ,20200814,9,0.73,61831,4995.94,244,19.72,2250285,181823.03,1355,1140,0.97,9,0,0
1301,台塑         ,20200817,1,0.08,61832,5039.31,1195,97.39,2251341,183484.29,1743,724,0.97,3,2,0
1301,台塑         ,20200818,55,4.48,61887,5037.6,278,22.63,2251378,183262.17,1868,1639,0.97,55,0,0
1301,台塑         ,20200819,7,0.55,61894,4982.47,-1008,-81.14,2251398,181237.54,1355,2406,0.97,7,0,0
1301,台塑         ,20200820,57,4.5,61951,4894.13,-3276,-258.8,2248508,177632.13,1214,4405,0.97,57,0,0
1301,台塑         ,20200821,70,5.59,62021,4949.28,-265,-21.15,2249392,179501.48,1104,1456,0.97,70,0,0
1301,台塑         ,20200824,8,0.64,62029,4912.7,-403,-31.92,2248922,178114.62,774,1171,0.97,8,0,0
1301,台塑         ,20200825,-63,-4.99,61966,4907.71,-264,-20.91,2248490,178080.41,1619,1842,0.97,0,63,0
1301,台塑         ,20200826,27,2.14,61993,4934.64,-320,-25.47,2246823,178847.11,1856,2170,0.97,27,0,0
1301,台塑         ,20200827,-450,-35.51,61543,4855.74,-1777,-140.21,2245371,177159.77,1071,2376,0.97,0,450,0
1301,台塑         ,20200828,-427,-33.69,61116,4822.05,-1152,-90.89,2244251,177071.4,2636,3351,0.96,23,450,0
1301,台塑         ,20200831,-422,-33.01,60694,4746.27,-1750,-136.85,2242519,175364.99,4746,6073,0.95,8,430,0
1301,台塑         ,20200901,-436,-33.94,60258,4694.1,-2393,-186.41,2240212,174512.51,4407,6339,0.95,28,464,0
1301,台塑         ,20200902,-478,-37.28,59780,4662.84,-1376,-107.33,2237422,174518.92,2582,3414,0.94,7,485,0
1301,台塑         ,20200903,-8,-0.62,59772,4686.12,413,32.38,2237965,175456.46,3082,2803,0.94,0,8,0
1301,台塑         ,20200904,3,0.24,59775,4692.34,-1209,-94.91,2238283,175705.22,2553,3746,0.94,3,0,0
1301,台塑         ,20200907,-335,-26.67,59440,4731.42,253,20.14,2237333,178091.71,2942,2391,0.93,72,407,0
1301,台塑         ,20200908,-843,-67.11,58597,4664.32,-597,-47.52,2236691,178040.6,1761,1554,0.92,7,850,0.01
1301,台塑         ,20200909,-445,-35.24,58152,4605.64,-1666,-131.95,2234833,176998.77,1598,2717,0.91,15,460,0
1301,台塑         ,20200910,0,0,58152,4576.56,-685,-53.91,2234116,175824.93,1249,1943,0.91,0,0,0
1301,台塑         ,20200911,-442,-34.92,57710,4559.09,-1188,-93.85,2233059,176411.66,2025,2742,0.91,18,460,0
1301,台塑         ,20200914,0,0,57710,4570.63,301,23.84,2233376,176883.38,1794,1481,0.91,0,0,0
1301,台塑         ,20200915,-414,-32.83,57296,4537.84,-359,-28.43,2233051,176857.64,1581,1529,0.9,61,475,0
1301,台塑         ,20200916,-428,-33.77,56868,4486.89,-126,-9.94,2232956,176180.23,1972,1576,0.89,132,560,0.01
1301,台塑         ,20200917,-445,-34.94,56423,4434.85,-1798,-141.32,2231311,175381.04,1186,2559,0.89,3,448,0
1301,台塑         ,20200918,-332,-27.09,56091,4577.03,10857,885.93,2241762,182927.78,19905,8988,0.88,303,635,0.01
1301,台塑         ,20200921,4,0.36,56095,4672.71,8175,680.98,2249951,187420.92,12114,3783,0.88,4,0,0
1301,台塑         ,20200922,-721,-58.68,55374,4507.44,-3864,-314.53,2247027,182908,2113,4943,0.87,2,723,0.01
1301,台塑         ,20200923,-805,-64.51,54569,4370.98,-4008,-321.04,2243150,179676.32,1023,3633,0.86,41,846,0.01
1301,台塑         ,20200924,-668,-52.1,53901,4204.28,-11500,-897,2231911,174089.06,2683,13207,0.85,0,668,0.01
1301,台塑         ,20200925,-648,-51.19,53253,4206.99,-720,-56.88,2231253,176268.99,3532,3586,0.84,74,722,0.01
1301,台塑         ,20200928,-430,-34.14,52823,4194.15,-678,-53.83,2231116,177150.61,1795,2024,0.83,250,680,0.01
1301,台塑         ,20200929,-470,-37.08,52353,4130.65,-201,-15.86,2230202,175962.94,4548,4323,0.82,44,514,0
1301,台塑         ,20200930,-619,-48.65,39360,3093.7,-416,-32.7,2216638,174227.75,3378,3205,0.62,0,619,0
1301,台塑         ,20201005,0,0,39360,3148.8,1252,100.16,2218044,177443.52,3713,2525,0.62,0,0,0
1301,台塑         ,20201006,9,0.73,39369,3196.76,1830,148.6,2220797,180328.72,3458,1650,0.62,9,0,0
1301,台塑         ,20201007,0,0,39369,3181.02,-396,-32,2220431,179410.82,2332,2771,0.62,0,0,0
1301,台塑         ,20201008,0,0,39369,3188.89,1264,102.38,2221705,179958.11,2768,1509,0.62,0,0,0
1301,台塑         ,20201012,0,0,39369,3196.76,960,77.95,2222338,180453.85,3046,2110,0.62,0,0,0
1301,台塑         ,20201013,-249,-20.14,39120,3164.81,308,24.92,2222985,179839.49,1790,1225,0.61,0,249,0
1301,台塑         ,20201014,-25,-2,39095,3127.6,-1395,-111.6,2221474,177717.92,4000,5210,0.61,0,25,0
1301,台塑         ,20201015,0,0,39095,3096.32,-3676,-291.14,2217747,175645.56,1683,5341,0.61,0,0,0
1301,台塑         ,20201016,-3,-0.24,39092,3088.27,-2280,-180.12,2215514,175025.61,1751,4010,0.61,7,10,0
1301,台塑         ,20201019,0,0,39092,3092.18,-914,-72.3,2214693,175182.22,1543,2472,0.61,0,0,0
1301,台塑         ,20201020,141,11.21,39233,3119.02,-101,-8.03,2214621,176062.37,1486,1704,0.62,243,102,0
1301,台塑         ,20201021,-30,-2.37,39203,3097.04,-2247,-177.51,2213015,174828.19,1611,3187,0.62,0,30,0
1301,台塑         ,20201022,251,20.03,39454,3148.43,874,69.75,2213866,176666.51,3403,2780,0.62,251,0,0
1301,台塑         ,20201023,-70,-5.59,39384,3142.84,-359,-28.65,2213594,176644.8,925,1181,0.62,0,70,0
1301,台塑         ,20201026,-483,-38.74,38901,3119.86,38,3.05,2214312,177587.82,1842,681,0.61,17,500,0
1301,台塑         ,20201027,-369,-29.63,38532,3094.12,40,3.21,2214464,177821.46,3323,2866,0.61,0,369,0
1301,台塑         ,20201028,0,0,38532,3063.29,-930,-73.94,2214096,176020.63,1169,1573,0.61,0,0,0
1301,台塑         ,20201029,-548,-43.24,37984,2996.94,-2038,-160.8,2212170,174540.21,1450,2945,0.6,0,548,0
1301,台塑         ,20201030,-379,-29.98,37605,2974.56,-1972,-155.99,2209925,174805.07,3453,4861,0.59,0,379,0
1301,台塑         ,20201102,-408,-32.52,37197,2964.6,455,36.26,2211018,176218.13,1737,884,0.58,12,420,0
1301,台塑         ,20201103,-116,-9.4,37081,3003.56,4755,385.16,2215817,179481.18,5913,1124,0.58,294,410,0.01
1301,台塑         ,20201104,-2,-0.16,37079,3014.52,1205,97.97,2217067,180247.55,2842,1637,0.58,317,319,0
1301,台塑         ,20201105,243,19.8,37322,3041.74,2066,168.38,2219076,180854.69,2884,1056,0.59,243,0,0
1301,台塑         ,20201106,-3,-0.24,37319,3041.5,1523,124.12,2220608,180979.55,2529,1007,0.59,0,3,0
1301,台塑         ,20201109,0,0,37319,3052.69,3570,292.03,2224233,181942.26,4332,1153,0.59,0,0,0
1301,台塑         ,20201110,2153,182.79,39472,3351.17,13543,1149.8,2238103,190014.94,10044,1231,0.62,2153,0,0.02
1301,台塑         ,20201111,4719,419.99,44191,3933,19827,1764.6,2257302,200899.88,17517,4019,0.69,5356,637,0.05
1301,台塑         ,20201112,91,8.01,44282,3896.82,5757,506.62,2262885,199133.88,9682,4516,0.7,91,0,0
1301,台塑         ,20201113,10,0.87,44292,3853.4,2944,256.13,2265829,197127.12,5357,3202,0.7,10,0,0
1301,台塑         ,20201116,517,45.55,44809,3947.67,5034,443.5,2270717,200050.17,12792,8329,0.7,517,0,0
1301,台塑         ,20201117,-63,-5.52,44746,3937.65,899,79.11,2271615,199902.12,5897,4493,0.7,32,95,0
1301,台塑         ,20201118,0,0,44746,3937.65,1909,167.99,2273559,200073.19,7333,4782,0.7,0,0,0
1301,台塑         ,20201119,250,22.03,44996,3964.15,-372,-32.77,2273131,200262.84,4766,4084,0.71,250,0,0
1301,台塑         ,20201120,-120,-10.6,44876,3962.55,1697,149.85,2274828,200867.31,4124,2423,0.7,14,134,0
1301,台塑         ,20201123,347,30.81,45223,4015.8,3031,269.15,2277881,202275.83,5471,2551,0.71,550,203,0.01
1301,台塑         ,20201124,-1676,-146.82,43547,3814.72,-2199,-192.63,2275643,199346.33,2662,2812,0.68,9,1685,0.01
1301,台塑         ,20201125,-406,-35.65,43141,3787.78,616,54.08,2276208,199851.06,3445,2384,0.68,0,406,0
1301,台塑         ,20201126,20,1.75,43161,3780.9,-875,-76.65,2275353,199320.92,2006,2856,0.68,20,0,0
1301,台塑         ,20201127,-111,-9.68,43050,3753.96,-2465,-214.95,2272888,198195.83,6202,5997,0.68,3,114,0
1301,台塑         ,20201130,6,0.51,43056,3668.37,-4802,-409.13,2267461,193187.68,12944,18035,0.68,7,1,0
1301,台塑         ,20201201,324,28.38,43380,3800.09,-282,-24.7,2267384,198622.84,3007,3134,0.68,512,188,0.01
1301,台塑         ,20201202,4,0.35,43384,3804.78,-357,-31.31,2268080,198910.62,6733,6033,0.68,25,21,0
1301,台塑         ,20201203,859,76.02,44243,3915.51,1429,126.47,2268549,200766.59,4934,4652,0.7,948,89,0.01
1301,台塑         ,20201204,124,11.07,44367,3961.97,2094,186.99,2271020,202802.09,6864,4776,0.7,134,10,0
1301,台塑         ,20201207,721,64.53,45088,4035.38,1445,129.33,2272422,203381.77,4047,3408,0.71,721,0,0.01
1301,台塑         ,20201208,469,41.98,45557,4077.35,2692,240.93,2274225,203543.14,4419,2135,0.72,851,382,0.01
1301,台塑         ,20201209,-355,-31.95,45202,4068.18,1393,125.37,2275051,204754.59,3964,2169,0.71,215,570,0.01
1301,台塑         ,20201210,-216,-19.42,44986,4044.24,1712,153.91,2276161,204626.87,3410,1966,0.71,15,231,0
1301,台塑         ,20201211,-1183,-106.24,43803,3933.51,169,15.18,2276161,204399.26,3233,2057,0.69,267,1450,0.01
1301,台塑         ,20201214,-16,-1.46,43787,3932.07,631,56.66,2276560,204435.09,2217,1333,0.69,54,70,0
1301,台塑         ,20201215,20,1.81,43807,3907.58,-693,-61.82,2276058,203024.37,3476,3857,0.69,20,0,0
1301,台塑         ,20201216,0,0,43807,3951.39,2845,256.62,2279497,205610.63,4576,1108,0.69,0,0,0
1301,台塑         ,20201217,-190,-17.03,43617,3916.81,-815,-73.19,2279139,204666.68,1747,2000,0.69,186,376,0
1301,台塑         ,20201218,-429,-37.87,43188,3809.18,-1603,-141.38,2277276,200855.74,4359,5771,0.68,0,429,0
1301,台塑         ,20201221,-87,-8.03,43101,3978.22,6073,560.54,2283380,210755.97,7262,1967,0.68,721,808,0.01
1301,台塑         ,20201222,625,57.55,43726,4027.16,-19,-1.75,2283430,210303.9,3617,4141,0.69,660,35,0.01
1301,台塑         ,20201223,-263,-24.06,43463,3976.86,-1937,-177.24,2281675,208773.26,665,2194,0.68,42,305,0
1301,台塑         ,20201224,9,0.88,43472,4025.51,787,72.88,2282295,211340.52,1455,790,0.68,9,0,0
1301,台塑         ,20201225,203,18.84,43675,4053.04,1078,100.04,2283175,211878.64,1194,517,0.69,203,0,0
1301,台塑         ,20201228,0,0,43675,4096.72,1475,138.36,2284755,214310.02,2551,971,0.69,0,0,0
1301,台塑         ,20201229,154,14.44,43829,4119.93,759,71.35,2285667,214852.7,2424,1680,0.69,237,83,0
1301,台塑         ,20201230,371,35.88,44200,4274.14,9095,879.49,2293974,221827.29,9376,1603,0.69,400,29,0
1301,台塑         ,20201231,1318,127.06,48390,4664.8,224,21.59,2300724,221789.79,3291,3339,0.76,1350,32,0.01
1301,台塑         ,20210104,-704,-68.12,47686,4611.24,1113,107.63,2301886,222592.38,5290,3271,0.75,7,711,0.01
1301,台塑         ,20210105,-614,-58.35,47072,4471.84,-2649,-251.66,2299266,218430.27,2204,3003,0.74,146,760,0.01
1301,台塑         ,20210106,53,5,47125,4448.6,756,71.37,2299999,217119.91,3934,2632,0.74,169,116,0
1301,台塑         ,20210107,267,25.94,47392,4601.76,7207,699.8,2310318,224331.88,9327,3320,0.74,288,21,0
1301,台塑         ,20210108,-830,-81.36,46562,4563.08,6093,597.11,2316807,227047.09,10498,3131,0.73,43,873,0.01
1301,台塑         ,20210111,-63,-6.23,46499,4603.4,3971,393.13,2320801,229759.3,7885,3649,0.73,87,150,0
1301,台塑         ,20210112,132,12.88,46631,4551.19,1468,143.28,2322221,226648.77,5994,4353,0.73,132,0,0
1301,台塑         ,20210113,-551,-54,46080,4515.84,2567,251.57,2324804,227830.79,6335,3497,0.72,168,719,0.01
1301,台塑         ,20210114,-732,-71.3,45348,4416.9,-1195,-116.39,2323796,226337.73,1914,2294,0.71,49,781,0.01
1301,台塑         ,20210115,-886,-83.73,44462,4201.66,-2760,-260.82,2318865,219132.74,3131,4990,0.7,59,945,0.01
1301,台塑         ,20210118,-687,-63.98,43775,4075.45,-900,-83.79,2317946,215800.77,3955,4150,0.69,34,721,0.01
1301,台塑         ,20210119,-1213,-113.05,42562,3966.78,-447,-41.66,2318083,216045.34,2138,1426,0.67,10,1223,0.01
1301,台塑         ,20210120,-1904,-174.38,40658,3724.27,-5201,-476.41,2313258,211894.43,4629,7935,0.64,9,1913,0.02
1301,台塑         ,20210121,-755,-69.01,39903,3647.13,-667,-60.96,2315791,211663.3,3635,3557,0.63,98,853,0.01
1301,台塑         ,20210122,-139,-12.59,39764,3602.62,-1172,-106.18,2314836,209724.14,5661,6806,0.62,23,162,0
1301,台塑         ,20210125,-446,-41.17,39318,3632.98,1746,161.33,2316523,214046.73,6018,4101,0.62,92,538,0
1301,台塑         ,20210126,-162,-14.76,39156,3567.11,-2442,-222.47,2314056,210810.5,5063,7239,0.62,30,192,0
1301,台塑         ,20210127,-122,-11.08,39034,3544.29,-1252,-113.68,2312497,209974.73,5644,6878,0.61,8,130,0
1301,台塑         ,20210128,10,0.89,39044,3478.82,-6572,-585.57,2306621,205519.93,2827,9495,0.61,10,0,0
1301,台塑         ,20210129,-460,-40.02,38584,3356.81,-6721,-584.73,2298644,199982.03,3650,9913,0.61,3,463,0
1301,台塑         ,20210201,7,0.62,38591,3399.87,-865,-76.21,2295797,202259.72,2397,3390,0.61,7,0,0
1301,台塑         ,20210202,6,0.54,38597,3477.59,-1044,-94.06,2294607,206744.09,3516,4620,0.61,6,0,0
1301,台塑         ,20210203,0,0,38597,3493.03,-2163,-195.75,2292254,207448.99,3354,5463,0.61,0,0,0
1301,台塑         ,20210204,12,1.09,38609,3494.11,-1527,-138.19,2290742,207312.15,1520,3070,0.61,15,3,0
1301,台塑         ,20210205,80,7.21,38689,3474.27,-7073,-635.16,2283127,205024.8,4765,11922,0.61,87,7,0
1301,台塑         ,20210217,881,84.75,39570,3806.63,7281,700.43,2290705,220365.82,13380,7271,0.62,881,0,0.01
1301,台塑         ,20210218,462,44.31,40032,3839.07,2518,241.48,2293300,219927.47,6772,4526,0.63,507,45,0
1301,台塑         ,20210219,24,2.29,40056,3817.34,343,32.69,2293436,218564.45,4838,4636,0.63,88,64,0
1301,台塑         ,20210222,175,16.99,40231,3906.43,2247,218.18,2295866,222928.59,6679,4601,0.63,235,60,0
1301,台塑         ,20210223,3958,394.61,44189,4405.64,15614,1556.72,2310763,230383.07,13750,2873,0.69,3958,0,0.03
1301,台塑         ,20210224,1648,164.8,45837,4583.7,5051,505.1,2315906,231590.6,10186,6239,0.72,1648,0,0.01
1301,台塑         ,20210225,308,30.8,46145,4614.5,4193,419.3,2320155,232015.5,7054,3116,0.72,319,11,0
1301,台塑         ,20210226,151,14.72,46296,4513.86,-8246,-803.99,2311435,225364.91,6919,14828,0.73,151,0,0
1301,台塑         ,20210302,67,6.58,46363,4552.85,1322,129.82,2312664,227103.6,5007,3781,0.73,572,505,0.01
1301,台塑         ,20210303,2755,278.26,49118,4960.92,8009,808.91,2320656,234386.26,13676,9137,0.77,2755,0,0.02
1301,台塑         ,20210304,1286,130.53,50404,5116.01,301,30.55,2320716,235552.67,5893,7121,0.79,1286,0,0.01
1301,台塑         ,20210305,579,58.77,50983,5174.77,18,1.83,2320327,235513.19,2344,2915,0.8,609,30,0.01
1301,台塑         ,20210308,1160,117.74,52143,5292.51,2308,234.26,2322499,235733.65,2631,1750,0.82,1375,215,0.01
1301,台塑         ,20210309,1699,174.15,53842,5518.81,4116,421.89,2326187,238434.17,4174,2007,0.85,1699,0,0.01
1301,台塑         ,20210310,1900,198.55,55742,5825.04,2380,248.71,2328524,243330.76,3927,3601,0.88,1902,2,0.01
1301,台塑         ,20210311,1837,192.89,57579,6045.8,5902,619.71,2333994,245069.37,5265,2303,0.9,1837,0,0.01
1301,台塑         ,20210312,443,46.52,58022,6092.31,1206,126.63,2335200,245196,2146,1354,0.91,450,7,0
1301,台塑         ,20210315,196,20.19,58218,5996.45,-1378,-141.93,2336473,240656.72,4263,5965,0.91,196,0,0
1301,台塑         ,20210316,-214,-21.61,58004,5858.4,948,95.75,2337356,236072.96,3512,3133,0.91,23,237,0
1301,台塑         ,20210317,113,11.41,58117,5869.82,-2309,-233.21,2334470,235781.47,3146,4858,0.91,113,0,0
1301,台塑         ,20210318,129,12.96,58246,5853.72,1737,174.57,2336182,234786.29,4388,2771,0.91,137,8,0
1301,台塑         ,20210319,-2850,-276.7,55396,5378.95,-7869,-764.08,2328313,226079.19,12071,17859,0.87,200,3050,0.03
1301,台塑         ,20210322,-1468,-146.8,53928,5392.8,422,42.2,2324543,232454.3,6982,5224,0.85,102,1570,0.01
1301,台塑         ,20210323,116,11.55,54044,5382.78,398,39.64,2324941,231564.12,2904,2463,0.85,150,34,0
1301,台塑         ,20210324,-854,-84.46,53190,5260.49,-2026,-200.37,2323987,229842.31,3242,4277,0.84,61,915,0.01
1301,台塑         ,20210325,-78,-7.8,53112,5311.2,1219,121.9,2325114,232511.4,3116,1801,0.83,42,120,0
1301,台塑         ,20210326,-454,-45.85,52658,5318.46,1578,159.38,2326675,234994.18,4592,2182,0.83,41,495,0
1301,台塑         ,20210329,-26,-2.64,52632,5342.15,-345,-35.02,2326508,236140.56,1690,2266,0.83,0,26,0
1301,台塑         ,20210330,106,10.61,52738,5300.17,311,31.26,2326898,233853.25,3373,2612,0.83,106,0,0
1301,台塑         ,20210331,-1024,-103.46,52718,5324.52,647,65.35,2325766,234902.37,4077,2344,0.83,8,1032,0.01
1301,台塑         ,20210401,-422,-42.43,52296,5255.75,448,45.02,2326245,233787.62,1980,1079,0.82,44,466,0
1301,台塑         ,20210406,-159,-16.08,52137,5265.84,322,32.52,2326618,234988.42,2324,1791,0.82,35,194,0
1301,台塑         ,20210407,-38,-3.82,52099,5235.95,390,39.2,2327236,233887.22,2459,2057,0.82,0,38,0
1301,台塑         ,20210408,-95,-9.55,52004,5226.4,1703,171.15,2328883,234052.74,3852,2401,0.82,15,110,0
1301,台塑         ,20210409,-308,-31.72,51696,5324.69,4984,513.35,2333866,240388.2,6166,2396,0.81,0,308,0
1301,台塑         ,20210412,9,0.96,51705,5325.62,232,23.9,2334124,240414.77,3923,4316,0.81,9,0,0
1301,台塑         ,20210413,-4061,-414.21,47644,4859.69,-2041,-208.18,2332057,237869.81,5484,2249,0.75,50,4111,0.03
1301,台塑         ,20210414,3041,316.22,50685,5271.24,9152,951.81,2340882,243451.73,6417,1248,0.8,3241,200,0.03
1301,台塑         ,20210415,2551,275.51,53236,5749.49,8654,934.63,2349536,253749.89,9687,5190,0.84,2551,0,0.02
1301,台塑         ,20210416,2026,220.83,55262,6023.56,916,99.84,2350451,256199.16,5198,6875,0.87,2030,4,0.02
1301,台塑         ,20210419,363,40.5,55625,6202.19,2934,327.14,2353401,262404.21,6079,2917,0.87,489,126,0
1301,台塑         ,20210420,881,96.51,56506,6187.41,1130,123.74,2354531,257821.14,4844,4274,0.89,902,21,0.01
1301,台塑         ,20210421,-335,-36.38,56171,6094.55,4584,497.36,2359116,255964.09,10405,3603,0.88,10,345,0
1301,台塑         ,20210422,-137,-14.81,56034,6051.67,2825,305.1,2362687,255170.2,10152,4908,0.88,9,146,0
1301,台塑         ,20210423,-499,-53.39,55535,5942.25,-2144,-229.41,2360113,252532.09,6225,8299,0.87,2,501,0
1301,台塑         ,20210426,-2488,-267.46,53047,5702.55,918,98.69,2359187,253612.6,5032,1471,0.83,0,2488,0.02
1301,台塑         ,20210427,-256,-27.78,52791,5727.82,4973,539.57,2364391,256536.42,6588,1128,0.83,0,256,0
1301,台塑         ,20210428,-1121,-118.78,51670,5477.02,297,31.48,2365045,250694.77,4001,2226,0.81,2,1123,0.01
1301,台塑         ,20210429,-1861,-197.22,49809,5279.75,2942,311.85,2369180,251133.08,9988,3995,0.78,3,1864,0.01
1301,台塑         ,20210503,-358,-38.49,49451,5315.98,5827,626.4,2375350,255350.13,9485,2957,0.78,146,504,0.01
1301,台塑         ,20210504,449,48.01,49900,5339.3,1616,172.91,2376668,254303.48,10386,10941,0.78,449,0,0
1301,台塑         ,20210505,232,25.02,50132,5414.26,718,77.54,2377372,256756.18,4730,4444,0.79,448,217,0.01
1301,台塑         ,20210506,1285,145.19,51417,5810.12,13656,1543.13,2391030,270186.39,15934,4833,0.81,1484,199,0.01
1301,台塑         ,20210507,-3126,-328.23,48291,5070.56,-6598,-692.79,2384401,250362.11,11581,18353,0.76,8,3134,0.02
1301,台塑         ,20210510,-1674,-177.42,46617,4941.4,2665,282.49,2387065,253028.89,6788,2542,0.73,15,1689,0.01
1301,台塑         ,20210511,-903,-92.56,45714,4685.69,-97,-9.94,2386667,244633.37,10927,4832,0.72,97,1000,0.01
1301,台塑         ,20210512,-678,-64.88,45036,4309.95,-3904,-373.61,2382763,228030.42,12904,15436,0.71,125,803,0.01
1301,台塑         ,20210513,-23,-2.17,45013,4244.73,-3533,-333.16,2376011,224057.84,5620,8877,0.71,42,65,0
1301,台塑         ,20210514,97,9.26,45110,4308.01,151,14.42,2375802,226889.09,6712,6834,0.71,97,0,0
1301,台塑         ,20210517,20,1.87,45130,4215.14,4308,402.37,2380587,222346.83,10542,6461,0.71,20,0,0
1301,台塑         ,20210518,479,46.89,45609,4465.12,1285,125.8,2381689,233167.35,6939,6599,0.72,479,0,0
1301,台塑         ,20210519,0,0,45609,4492.49,448,44.13,2366519,233102.12,4200,3738,0.72,0,0,0
1301,台塑         ,20210520,-123,-11.91,45486,4403.04,-942,-91.19,2365695,228999.28,5329,5846,0.71,0,123,0
1301,台塑         ,20210521,0,0,45486,4462.18,1298,127.33,2366960,232198.78,4127,2840,0.71,0,0,0
1301,台塑         ,20210524,0,0,45486,4498.57,1105,109.28,2368172,234212.21,4232,2847,0.71,0,0,0
1301,台塑         ,20210525,45,4.61,45531,4666.93,3515,360.29,2371624,243091.46,8575,5247,0.72,53,8,0
1301,台塑         ,20210526,-178,-18.07,45353,4603.33,242,24.56,2372168,240775.05,2941,2673,0.71,3,181,0
1301,台塑         ,20210527,-117,-11.82,45236,4568.84,305,30.81,2372887,239661.59,9613,9111,0.71,10,127,0
1301,台塑         ,20210528,-514,-52.17,44722,4539.28,1424,144.54,2374515,241013.27,5387,3804,0.7,0,514,0
1301,台塑         ,20210531,157,16.29,44879,4644.98,4671,483.45,2377193,246039.48,5944,2036,0.71,198,41,0
1301,台塑         ,20210601,-168,-17.3,44711,4605.23,-95,-9.79,2376445,244773.84,1387,1398,0.7,0,168,0
1301,台塑         ,20210602,0,-0.04,44711,4739.37,4976,527.46,2381387,252427.02,6191,1952,0.7,0,0,0
1301,台塑         ,20210603,20,2.13,44731,4741.49,1195,126.67,2382601,252555.71,2812,1740,0.7,21,1,0
1301,台塑         ,20210604,0,-0.05,44731,4741.49,2859,303.05,2385222,252833.53,4074,1301,0.7,0,0,0
1301,台塑         ,20210607,4,0.48,44735,4764.28,2404,256.03,2387626,254282.17,4048,1771,0.7,5,1,0
1301,台塑         ,20210608,-1310,-136.24,43425,4516.2,-1088,-113.15,2385567,248098.97,3072,2676,0.68,7,1317,0.01
1301,台塑         ,20210609,-65,-6.7,43360,4466.08,702,72.31,2385784,245735.75,4750,2959,0.68,0,65,0
1301,台塑         ,20210610,-8,-0.84,43352,4573.64,3787,399.53,2388984,252037.81,5921,2124,0.68,0,8,0
1301,台塑         ,20210611,-106,-10.97,43246,4475.96,-390,-40.37,2388353,247194.54,1757,2030,0.68,27,133,0
1301,台塑         ,20210615,-2,-0.21,43244,4497.38,942,97.97,2389294,248486.58,2724,1794,0.68,0,2,0
1301,台塑         ,20210616,-6,-0.66,43238,4518.37,1996,208.58,2391133,249873.4,3058,2227,0.68,0,6,0
1301,台塑         ,20210617,0,0,43238,4475.13,24,2.48,2390423,247408.78,2021,1912,0.68,0,0,0
1301,台塑         ,20210618,-1808,-184.42,41430,4225.86,-3194,-325.79,2387229,243497.36,7249,7861,0.65,0,1808,0.01
1301,台塑         ,20210621,19,1.95,41449,4144.9,-2260,-226,2384965,238496.5,3349,5427,0.65,19,0,0
1301,台塑         ,20210622,-502,-51.2,40947,4176.59,3941,401.98,2388759,243653.42,5787,1395,0.64,0,502,0
1301,台塑         ,20210623,-29,-3,40918,4235.01,2644,273.65,2391494,247519.63,2342,1246,0.64,26,55,0
1301,台塑         ,20210624,-18,-1.85,40900,4212.7,928,95.58,2392291,246405.97,1806,1143,0.64,26,44,0
1301,台塑         ,20210625,-423,-43.99,40477,4209.61,1300,135.2,2393714,248946.26,3472,2136,0.64,13,436,0
1301,台塑         ,20210628,-150,-15.45,40327,4153.68,921,94.86,2394770,246661.31,2348,1305,0.63,0,150,0
1301,台塑         ,20210629,-3,-0.31,40324,4193.7,658,68.43,2395428,249124.51,3595,2854,0.63,4,7,0
1301,台塑         ,20210630,-998,-102.79,47742,4917.43,-865,-89.1,2400678,247269.83,4378,4337,0.75,0,998,0.01
1301,台塑         ,20210701,-47,-4.89,47695,4960.28,1556,161.82,2402250,249834,4468,2849,0.75,0,47,0
1301,台塑         ,20210702,-2,-0.21,47693,5007.77,1509,158.44,2403700,252388.5,5135,4072,0.75,0,2,0
1301,台塑         ,20210705,-26,-2.84,47667,5124.2,4705,505.79,2408405,258903.54,6668,2041,0.75,0,26,0
1301,台塑         ,20210706,0,0,47667,5052.7,2558,271.15,2410794,255544.16,3733,1503,0.75,0,0,0
1301,台塑         ,20210707,-755,-79.28,46912,4925.76,232,24.36,2411027,253157.84,3108,2117,0.74,0,755,0.01
1301,台塑         ,20210708,1,0.06,46913,4855.5,1806,186.92,2412402,249683.61,3640,1936,0.74,1,0,0
1301,台塑         ,20210709,-2715,-281,44198,4574.49,-937,-96.98,2411464,249586.52,7930,6202,0.69,21,2736,0.02
1301,台塑         ,20210712,450,46.35,44648,4598.74,926,95.38,2412447,248482.04,3141,2714,0.7,460,10,0
1301,台塑         ,20210713,-11,-1.12,44637,4597.61,1726,177.78,2414584,248702.15,4839,3209,0.7,0,11,0
1301,台塑         ,20210714,-60,-6.24,44577,4613.72,2279,235.88,2415219,249975.17,4012,1735,0.7,94,154,0
1301,台塑         ,20210715,15,1.59,44592,4637.57,1692,175.97,2417062,251374.45,3115,1456,0.7,24,9,0
1301,台塑         ,20210716,-65,-6.79,44527,4653.07,1407,147.03,2418224,252704.41,3494,1791,0.7,0,65,0
1301,台塑         ,20210719,0,0,44527,4564.02,-2135,-218.84,2416089,247649.12,2331,4186,0.7,0,0,0
1301,台塑         ,20210720,-693,-70.34,43834,4449.15,-362,-36.74,2417133,245339,2568,2122,0.69,7,700,0.01
1301,台塑         ,20210721,-2552,-255.2,41282,4128.2,-4235,-423.5,2412898,241289.8,2444,5996,0.65,10,2562,0.02
1301,台塑         ,20210722,11,1.17,41293,4211.89,-311,-31.72,2412265,246051.03,4421,4738,0.65,11,0,0
1301,台塑         ,20210723,-164,-16.65,41129,4174.59,-125,-12.69,2413711,244991.67,969,897,0.65,0,164,0
1301,台塑         ,20210726,-6,-0.6,41123,4087.63,-2330,-231.6,2410837,239637.2,2204,4325,0.65,0,6,0
1301,台塑         ,20210727,45,4.49,41168,4104.45,1851,184.54,2412688,240544.99,3586,1744,0.65,45,0,0
1301,台塑         ,20210728,99,9.93,41267,4126.7,272,27.2,2410806,241080.6,4167,4696,0.65,99,0,0
1301,台塑         ,20210729,8,0.77,41275,4210.05,2239,228.38,2413045,246130.59,4662,2565,0.65,14,6,0
1301,台塑         ,20210730,-14,-1.38,41261,4117.85,-2497,-249.2,2407575,240275.98,6304,8738,0.65,0,14,0
1301,台塑         ,20210802,-1,-0.1,41260,4208.52,2986,304.57,2411037,245925.77,4371,912,0.65,0,1,0
1301,台塑         ,20210803,-162,-16.32,41098,4150.9,-1670,-168.67,2409817,243391.52,1535,2580,0.65,0,162,0
1301,台塑         ,20210804,11,1.13,41109,4172.56,195,19.79,2410516,244667.37,1974,1242,0.65,16,5,0
1301,台塑         ,20210805,-83,-8.36,41026,4143.63,1127,113.83,2411647,243576.35,2972,1743,0.64,0,83,0
1301,台塑         ,20210806,0,0,41026,4205.17,2860,293.15,2414662,247502.86,4273,1251,0.64,0,0,0
1301,台塑         ,20210809,0,0,41026,4164.14,-1433,-145.45,2413783,244998.97,2519,3899,0.64,0,0,0
1301,台塑         ,20210810,8,0.8,41034,4082.88,-3209,-319.3,2410550,239849.73,1806,5046,0.64,8,0,0
1301,台塑         ,20210811,-17,-1.71,41017,4122.21,1672,168.04,2412213,242427.41,2792,1112,0.64,39,56,0
1301,台塑         ,20210812,-20,-2.01,40997,4120.2,101,10.15,2412290,242435.14,1083,991,0.64,16,36,0
1301,台塑         ,20210813,19,1.9,41016,4093.4,-992,-99,2411345,240652.23,1746,2710,0.64,19,0,0
1301,台塑         ,20210816,36,3.57,41052,4076.46,124,12.31,2411443,239456.29,3140,3016,0.64,36,0,0
1301,台塑         ,20210817,14,1.38,41066,4061.43,-148,-14.64,2411264,238474.01,2838,2974,0.65,14,0,0
1301,台塑         ,20210818,68,6.77,41134,4092.83,772,76.81,2411896,239983.65,3702,3137,0.65,68,0,0
1301,台塑         ,20210819,42,4.06,41176,3981.72,-3902,-377.32,2408175,232870.52,2494,6166,0.65,49,7,0
1301,台塑         ,20210820,-227,-21.77,40949,3922.91,-1683,-161.23,2406136,230507.83,2221,3678,0.64,76,303,0
1301,台塑         ,20210823,41,4.02,40990,4017.02,269,26.36,2406352,235822.5,1725,1514,0.64,41,0,0
1301,台塑         ,20210824,18,1.78,41008,4063.89,444,44,2407077,238541.33,2368,1993,0.64,18,0,0
1301,台塑         ,20210825,13,1.29,41021,4081.59,-458,-45.57,2406565,239453.22,2141,2679,0.64,13,0,0
1301,台塑         ,20210826,93,9.2,41114,4066.17,-749,-74.08,2405710,237924.72,1832,2768,0.65,93,0,0
1301,台塑         ,20210827,150,15.08,41264,4147.03,1998,200.8,2407404,241944.1,2842,1298,0.65,150,0,0
1301,台塑         ,20210830,253,25.93,41517,4255.49,4093,419.53,2411477,247176.39,5827,2052,0.65,253,0,0
1301,台塑         ,20210831,116,11.89,41633,4267.38,582,59.66,2412072,247237.38,4927,4539,0.65,116,0,0
1301,台塑         ,20210901,-26,-2.6,41607,4160.7,-3050,-305,2409215,240921.5,3130,6133,0.65,0,26,0
1301,台塑         ,20210902,-8,-0.82,41599,4109.98,-2602,-257.08,2407296,237840.84,2421,4948,0.65,3,11,0
1301,台塑         ,20210903,5,0.53,41604,4181.2,351,35.28,2407505,241954.25,3716,3596,0.65,12,7,0
1301,台塑         ,20210906,-19,-1.89,41585,4129.39,-1261,-125.22,2406289,238944.5,1722,3003,0.65,0,19,0
1301,台塑         ,20210907,217,21.82,41802,4201.1,1484,149.14,2407774,241981.29,2942,1550,0.66,227,10,0
1301,台塑         ,20210908,352,35.38,42154,4236.48,99,9.95,2408261,242030.23,2759,2573,0.66,356,4,0
1301,台塑         ,20210909,676,66.99,42830,4244.45,-1862,-184.52,2406448,238479,2740,5228,0.67,683,7,0.01
1301,台塑         ,20210910,12,1.19,42842,4249.93,-1781,-176.68,2404705,238546.74,4490,6245,0.67,20,8,0
1301,台塑         ,20210913,1340,134.67,44182,4440.29,1879,188.84,2406226,241825.71,5113,4932,0.69,1340,0,0.01
1301,台塑         ,20210914,788,80.38,44970,4586.94,2638,269.08,2408859,245703.62,5441,3837,0.71,788,0,0.01
1301,台塑         ,20210915,1872,190.94,46842,4777.88,1785,182.07,2410927,245914.55,3366,3127,0.74,1875,3,0.01
1301,台塑         ,20210916,3189,328.47,50031,5153.19,5998,617.79,2418875,249144.13,5015,2632,0.79,3189,0,0.03
1301,台塑         ,20210917,628,64.03,50659,5167.22,43,4.39,2418924,246730.25,6948,7698,0.8,667,39,0.01
1301,台塑         ,20210922,205,20.53,50864,5086.4,-1599,-159.9,2417537,241753.7,3808,4730,0.8,205,0,0
1301,台塑         ,20210923,172,17.63,51036,5231.19,2470,253.18,2419804,248029.91,4680,2447,0.8,172,0,0
1301,台塑         ,20210924,2661,282.07,53697,5691.88,9429,999.47,2429038,257478.03,8260,2569,0.84,2661,0,0.02
1301,台塑         ,20210927,3894,434.14,57591,6421.4,8635,962.8,2437926,271828.75,8553,5524,0.9,3894,0,0.03
1301,台塑         ,20210928,6663,759.56,64254,7324.96,6447,734.96,2444177,278636.18,8412,8783,1.01,6663,0,0.05
1301,台塑         ,20210929,6910,784.3,71164,8077.11,7921,899.03,2452114,278314.94,12997,11037,1.12,6932,22,0.05
1301,台塑         ,20210930,435,49.33,69361,7872.47,1274,144.6,2449792,278051.39,10369,9498,1.09,437,2,0
1301,台塑         ,20211001,1667,183.37,71028,7813.08,2934,322.74,2452359,269759.49,7485,6514,1.12,1667,0,0.01
1301,台塑         ,20211004,1486,164.92,72514,8049.05,3810,422.91,2455503,272560.83,6224,4043,1.14,1486,0,0.01
1301,台塑         ,20211005,6797,781.66,79311,9120.77,10380,1193.7,2465795,283566.43,13331,9677,1.25,6797,0,0.05
1301,台塑         ,20211006,4336,511.65,83647,9870.35,3680,434.24,2469369,291385.54,10060,11110,1.31,4336,0,0.03
1301,台塑         ,20211007,903,106.55,84550,9976.9,6526,770.07,2475596,292120.33,11387,6971,1.33,909,6,0.01
1301,台塑         ,20211008,635,74.93,85185,10051.83,3061,361.2,2478544,292468.19,7064,3987,1.34,635,0,0
1301,台塑         ,20211012,235,27.6,85420,10036.85,3242,380.94,2481564,291583.77,10073,7070,1.34,235,0,0
1301,台塑         ,20211013,496,57.27,85916,9923.3,5250,606.38,2486780,287223.09,11707,6748,1.35,546,50,0
1301,台塑         ,20211014,-569,-64.88,85347,9729.56,2425,276.45,2489417,283793.54,8191,5453,1.34,38,607,0.01
1301,台塑         ,20211015,-291,-33.33,85056,9738.91,716,81.98,2490429,285154.12,6227,3316,1.34,135,426,0
1301,台塑         ,20211018,510,58.61,85566,9840.09,793,91.2,2491125,286479.38,5279,5093,1.34,510,0,0
1301,台塑         ,20211019,574,65.47,86140,9819.96,1197,136.46,2492117,284101.34,2736,3494,1.35,632,58,0.01
1301,台塑         ,20211020,-2036,-231.1,84104,9545.8,-2644,-300.09,2489715,282582.65,8909,8327,1.32,99,2135,0.02
1301,台塑         ,20211021,-1227,-139.21,82877,9406.54,3312,375.91,2493218,282980.24,17392,12754,1.3,33,1260,0.01
1301,台塑         ,20211022,-2207,-242.8,80670,8873.7,-4120,-453.2,2489475,273842.25,2908,4445,1.27,83,2290,0.02
1301,台塑         ,20211025,-219,-24.42,80451,8970.29,3023,337.06,2493136,277984.66,5270,1895,1.26,29,248,0
1301,台塑         ,20211026,-4,-0.44,80447,8849.17,-633,-69.63,2492528,274178.08,6476,7080,1.26,14,18,0
1301,台塑         ,20211027,-565,-62.72,79882,8866.9,489,54.28,2492995,276722.45,4405,3321,1.25,1641,2206,0.03
1301,台塑         ,20211028,-819,-88.45,79063,8538.8,-3749,-404.89,2489529,268869.13,3030,5553,1.24,0,819,0.01
1301,台塑         ,20211029,-1937,-208.23,77126,8291.05,-1175,-126.31,2488517,267515.58,8266,7341,1.21,147,2084,0.02
1301,台塑         ,20211101,-2290,-245.03,74836,8007.45,-1807,-193.35,2486802,266087.81,5189,4588,1.18,169,2459,0.02
1301,台塑         ,20211102,-3520,-374.88,71316,7595.15,-2672,-284.57,2484012,264547.28,6567,5915,1.12,26,3546,0.03
1301,台塑         ,20211103,-2665,-286.49,68651,7379.98,-425,-45.69,2482717,266892.08,4964,3144,1.08,7,2672,0.02
1301,台塑         ,20211104,-1851,-196.21,66800,7080.8,-2168,-229.81,2480599,262943.49,3970,4272,1.05,29,1880,0.01
1301,台塑         ,20211105,0,0,66800,7147.6,609,65.16,2481224,265490.97,5312,4765,1.05,0,0,0
1301,台塑         ,20211108,195,21.45,66995,7369.45,2338,257.18,2483651,273201.61,8663,7094,1.05,195,0,0
1301,台塑         ,20211109,-1461,-157.09,65534,7044.91,-1999,-214.89,2481986,266813.5,5503,5980,1.03,445,1906,0.02
1301,台塑         ,20211110,77,8.24,65611,7020.38,-3945,-422.12,2478649,265215.44,2959,7172,1.03,155,78,0
1301,台塑         ,20211111,-2965,-312.81,62646,6609.15,-6885,-726.37,2471930,260788.62,4063,7369,0.98,251,3216,0.03
1301,台塑         ,20211112,-195,-20.96,62451,6713.48,3200,344,2475035,266066.26,4872,1663,0.98,185,380,0
1301,台塑         ,20211115,-214,-22.9,62237,6659.36,-2151,-230.16,2473407,264654.55,3393,4783,0.98,0,214,0
1301,台塑         ,20211116,-514,-54.74,61723,6573.5,-1467,-156.24,2471624,263227.96,3243,4297,0.97,283,797,0.01
1301,台塑         ,20211117,402,42.61,62125,6585.25,-3524,-373.54,2468449,261655.59,2831,9731,0.98,2369,1967,0.03
1301,台塑         ,20211118,168,17.98,62293,6665.35,3746,400.82,2471853,264488.27,5923,2484,0.98,275,107,0
1301,台塑         ,20211119,-881,-91.2,61412,6356.14,-9840,-1018.44,2462282,254846.19,1834,10661,0.96,46,927,0.01
1301,台塑         ,20211122,-683,-71.37,60729,6346.18,709,74.09,2463058,257389.56,5484,4071,0.95,22,705,0.01
1301,台塑         ,20211123,0,0,60729,6376.55,2,0.21,2463126,258628.23,3650,3636,0.95,0,0,0
