證券名稱,簡稱,年月日,投信買賣超(千股),投信買賣超市值(百萬),投信持股數(千股),投信持股數市值(百萬),合計買賣超(千股),合計買賣超市值(百萬),合計持股數(千股),合計持股數市值(百萬),外資買進張數,外資賣出張數,投信持股率%,投信買進張數,投信賣出張數,投信週轉率%
1303,南亞         ,20130102,0,0,83597,4731.59,2540,143.76,2149309,121650.89,5130,2460,1.06,0,0,0
1303,南亞         ,20130103,740,43.66,84337,4975.88,7016,413.94,2154625,127122.88,6560,278,1.07,750,10,0
1303,南亞         ,20130104,1516,90.96,85853,5151.18,5046,302.76,2159811,129588.66,8115,4210,1.09,1540,24,0.01
1303,南亞         ,20130107,233,13.72,86086,5070.47,1975,116.33,2161946,127338.62,7265,5535,1.1,360,127,0
1303,南亞         ,20130108,90,5.27,86176,5041.3,720,42.12,2162676,126516.55,3830,3157,1.1,95,5,0
1303,南亞         ,20130109,47,2.71,86223,4975.07,-146,-8.42,2161465,124716.53,3943,4139,1.1,96,49,0
1303,南亞         ,20130110,560,32.98,86783,5111.52,3508,206.62,2165126,127525.92,9306,6555,1.11,560,0,0
1303,南亞         ,20130111,309,18.32,87092,5164.56,1511,89.6,2166653,128482.52,2584,1388,1.11,321,12,0
1303,南亞         ,20130114,-150,-8.91,86942,5164.35,-432,-25.66,2164387,128564.59,2849,2738,1.11,0,150,0
1303,南亞         ,20130115,139,8.26,87081,5172.61,1059,62.9,2165630,128638.42,3294,2013,1.11,147,8,0
1303,南亞         ,20130116,-25,-1.46,87056,5092.78,582,34.05,2166305,126728.84,4094,3474,1.11,0,25,0
1303,南亞         ,20130117,-16,-0.91,87040,5117.95,1552,91.26,2167211,127432.01,7593,5876,1.11,96,112,0
1303,南亞         ,20130118,-408,-24.24,86632,5145.94,54,3.21,2167419,128744.69,2382,1836,1.1,0,408,0
1303,南亞         ,20130121,378,22.23,87010,5116.19,955,56.15,2168820,127526.62,1615,1000,1.11,427,49,0
1303,南亞         ,20130122,144,8.5,87154,5142.09,1990,117.41,2170720,128072.48,2224,445,1.11,160,16,0
1303,南亞         ,20130123,46,2.73,87200,5170.96,1553,92.09,2172270,128815.61,2175,654,1.11,52,6,0
1303,南亞         ,20130124,-21,-1.24,87179,5134.84,66,3.89,2172643,127968.67,3132,2627,1.11,4,25,0
1303,南亞         ,20130125,-1453,-84.42,85726,4980.68,-2115,-122.88,2170591,126111.34,3872,4437,1.09,0,1453,0.01
1303,南亞         ,20130128,-193,-11.19,85533,4960.91,475,27.55,2171110,125924.38,1521,809,1.09,0,193,0
1303,南亞         ,20130129,-424,-24.85,85109,4987.39,1396,81.81,2172447,127305.39,2372,516,1.08,0,424,0
1303,南亞         ,20130130,319,18.95,85428,5074.42,2711,161.03,2175205,129207.18,4114,1543,1.09,319,0,0
1303,南亞         ,20130131,69,4.14,85497,5129.82,2789,167.34,2177111,130626.66,6251,3411,1.09,78,9,0
1303,南亞         ,20130201,256,15.26,85753,5110.88,-304,-18.12,2176874,129741.69,2489,2992,1.09,256,0,0
1303,南亞         ,20130204,-410,-24.6,85343,5120.58,489,29.34,2177548,130652.88,2755,1919,1.09,148,558,0
1303,南亞         ,20130205,-142,-8.42,85201,5052.42,1233,73.12,2179022,129216,3164,1646,1.09,0,142,0
1303,南亞         ,20130206,75,4.41,85276,5014.23,536,31.52,2180346,128204.34,5974,4725,1.09,155,80,0
1303,南亞         ,20130218,59,3.42,85335,4949.43,173,10.03,2181297,126515.23,7567,6826,1.09,147,88,0
1303,南亞         ,20130219,-350,-20.44,84985,4963.12,-827,-48.3,2180984,127369.47,1783,1806,1.08,0,350,0
1303,南亞         ,20130220,0,0,84985,5099.1,4875,292.5,2186125,131167.5,7239,2127,1.08,0,0,0
1303,南亞         ,20130221,-12,-0.72,84973,5089.88,1260,75.47,2188044,131063.84,6345,4556,1.08,0,12,0
1303,南亞         ,20130222,1,0.06,84974,5047.46,116,6.89,2188223,129980.45,2260,2075,1.08,49,48,0
1303,南亞         ,20130223,75,4.44,85049,5034.9,-79,-4.68,2188304,129547.6,8,2,1.08,85,10,0
1303,南亞         ,20130225,13,0.76,85062,4976.13,-1690,-98.87,2186898,127933.53,3118,4473,1.08,15,2,0
1303,南亞         ,20130226,-585,-34.16,84477,4933.46,-956,-55.83,2186260,127677.58,6846,7000,1.08,20,605,0
1303,南亞         ,20130227,-629,-35.79,83848,4770.95,-1375,-78.24,2185600,124360.64,3645,4426,1.07,0,629,0
1303,南亞         ,20130301,-1660,-95.45,82188,4725.81,-920,-52.9,2184744,125622.78,7207,6403,1.05,0,1660,0.01
1303,南亞         ,20130304,-312,-17.25,81876,4527.74,-6421,-355.08,2178559,120474.31,3851,10221,1.04,0,312,0
1303,南亞         ,20130305,-486,-26.58,81390,4452.03,-3845,-210.32,2175017,118973.43,2721,5580,1.04,0,486,0
1303,南亞         ,20130306,-37,-2.07,81353,4555.77,1585,88.76,2175960,121853.76,4175,2675,1.04,0,37,0
1303,南亞         ,20130307,0,0,81353,4547.63,16,0.89,2176389,121660.15,1514,1315,1.04,0,0,0
1303,南亞         ,20130308,-84,-4.73,81269,4575.44,670,37.72,2177251,122579.23,4951,4205,1.03,109,193,0
1303,南亞         ,20130311,364,21,81633,4710.22,970,55.97,2179377,125750.05,4718,3982,1.04,373,9,0
1303,南亞         ,20130312,571,33.18,82204,4776.05,891,51.77,2180340,126677.75,3633,3381,1.05,574,3,0
1303,南亞         ,20130313,-7,-0.39,82197,4611.25,-2788,-156.41,2178292,122202.18,1543,3654,1.05,0,7,0
1303,南亞         ,20130314,-1123,-61.32,81074,4426.64,-3407,-186.02,2175305,118771.65,2328,4362,1.03,0,1123,0.01
1303,南亞         ,20130315,-10040,-527.1,71034,3729.29,-14736,-773.64,2160097,113405.09,14643,19619,0.9,0,10040,0.06
1303,南亞         ,20130318,73,3.87,71107,3768.67,-1399,-74.15,2158645,114408.19,2336,3860,0.91,86,13,0
1303,南亞         ,20130319,-73,-3.84,71034,3736.39,-2950,-155.17,2155833,113396.82,2251,5041,0.9,20,93,0
1303,南亞         ,20130320,5,0.26,71039,3708.24,-4453,-232.45,2149670,112212.77,1655,6216,0.9,10,5,0
1303,南亞         ,20130321,60,3.14,71099,3718.48,-1820,-95.19,2148030,112341.97,1344,3172,0.91,60,0,0
1303,南亞         ,20130322,-196,-10.13,70903,3665.69,-2192,-113.33,2145943,110945.25,1109,3000,0.9,0,196,0
1303,南亞         ,20130325,0,0,70903,3686.96,-382,-19.86,2145575,111569.9,1452,1820,0.9,0,0,0
1303,南亞         ,20130326,0,0,70903,3651.5,-1040,-53.56,2144273,110430.06,1576,2686,0.9,0,0,0
1303,南亞         ,20130327,-307,-16.18,70596,3720.41,1608,84.74,2145949,113091.51,2819,836,0.9,2,309,0
1303,南亞         ,20130328,-481,-25.3,70115,3688.05,917,48.23,2146965,112930.36,4678,3261,0.89,0,481,0
1303,南亞         ,20130329,-445,-23.85,59408,3184.27,2846,152.55,2139385,114671.04,4128,1021,0.76,1,446,0
1303,南亞         ,20130401,-5,-0.26,59403,3142.42,-352,-18.62,2139093,113158.02,616,1013,0.76,0,5,0
1303,南亞         ,20130402,-7,-0.38,59396,3189.57,1205,64.71,2140348,114936.69,3653,2628,0.76,0,7,0
1303,南亞         ,20130403,0,0,59396,3136.11,-352,-18.59,2139897,112986.56,1230,1765,0.76,0,0,0
1303,南亞         ,20130408,-8,-0.41,59388,3064.42,-1154,-59.55,2138743,110359.14,3055,4222,0.76,0,8,0
1303,南亞         ,20130409,-12,-0.62,59376,3057.86,-2344,-120.72,2136449,110027.12,1157,3380,0.76,0,12,0
1303,南亞         ,20130410,128,6.53,59504,3034.7,318,16.22,2136767,108975.12,4647,4486,0.76,128,0,0
1303,南亞         ,20130411,191,10.01,59695,3128.02,-986,-51.67,2135816,111916.76,1086,2071,0.76,191,0,0
1303,南亞         ,20130412,-2,-0.11,59693,3151.79,-184,-9.72,2135737,112766.91,959,1088,0.76,0,2,0
1303,南亞         ,20130415,490,26.31,60183,3231.83,608,32.65,2136561,114733.33,1807,1515,0.77,500,10,0
1303,南亞         ,20130416,-49,-2.65,60134,3253.25,-238,-12.88,2136797,115600.72,2981,2886,0.77,0,49,0
1303,南亞         ,20130417,886,47.93,61020,3301.18,-484,-26.18,2136537,115586.65,3778,5184,0.78,1000,114,0.01
1303,南亞         ,20130418,0,0,61020,3240.16,-1704,-90.48,2134838,113359.9,1380,3134,0.78,0,0,0
1303,南亞         ,20130419,-63,-3.36,60957,3267.3,151,8.09,2134885,114429.84,2005,1759,0.78,37,100,0
1303,南亞         ,20130422,485,26.58,61442,3367.02,1510,82.75,2136219,117064.8,1976,1306,0.78,500,15,0
1303,南亞         ,20130423,-30,-1.67,61412,3420.65,3339,185.98,2139628,119177.28,5514,2659,0.78,81,111,0
1303,南亞         ,20130424,881,51.45,62293,3637.91,6665,389.24,2146403,125349.94,8792,2530,0.79,884,3,0.01
1303,南亞         ,20130425,1443,85.71,63736,3785.92,5400,320.76,2152374,127851.02,7348,2666,0.81,1465,22,0.01
1303,南亞         ,20130426,859,51.2,64595,3849.86,4894,291.68,2157911,128611.5,6867,2259,0.82,869,10,0.01
1303,南亞         ,20130429,-162,-9.69,64433,3853.09,5545,331.59,2163959,129404.75,7188,1354,0.82,0,162,0
1303,南亞         ,20130430,53,3.12,64486,3791.78,1307,76.85,2164582,127277.42,5928,5398,0.82,53,0,0
1303,南亞         ,20130502,-126,-7.51,64360,3835.86,5458,325.3,2169960,129329.62,5549,886,0.82,0,126,0
1303,南亞         ,20130503,380,22.69,64740,3864.98,2537,151.46,2171860,129660.04,3370,985,0.82,405,25,0
1303,南亞         ,20130506,-12,-0.71,64728,3851.32,3177,189.03,2175036,129414.64,4595,1286,0.82,0,12,0
1303,南亞         ,20130507,1579,97.11,66307,4077.88,9905,609.16,2185102,134383.77,9378,1342,0.84,1581,2,0.01
1303,南亞         ,20130508,3014,192.9,69321,4436.54,6279,401.86,2193827,140404.93,6875,3723,0.88,3017,3,0.02
1303,南亞         ,20130509,96,6.07,69417,4387.15,3753,237.19,2197789,138900.26,4548,1459,0.88,105,9,0
1303,南亞         ,20130510,-402,-24.96,69015,4285.83,1058,65.7,2198887,136550.88,3817,3018,0.88,56,458,0
1303,南亞         ,20130513,166,10.11,69181,4213.12,-111,-6.76,2198806,133907.29,3090,3743,0.88,181,15,0
1303,南亞         ,20130514,490,30.72,69671,4368.37,5000,313.5,2203946,138187.41,5003,1364,0.89,493,3,0
1303,南亞         ,20130515,298,18.68,69969,4387.06,2048,128.41,2206103,138322.66,5044,2768,0.89,300,2,0
1303,南亞         ,20130516,987,64.06,70956,4605.04,4581,297.31,2210377,143453.47,5298,1377,0.9,987,0,0.01
1303,南亞         ,20130517,167,10.79,71123,4594.55,1355,87.53,2211982,142894.04,2345,1191,0.91,200,33,0
1303,南亞         ,20130520,145,9.28,71268,4561.15,452,28.93,2212716,141613.82,1555,1558,0.91,154,9,0
1303,南亞         ,20130521,-195,-12.48,71073,4548.67,87,5.57,2212597,141606.21,1329,1156,0.91,0,195,0
1303,南亞         ,20130522,90,5.76,71163,4554.43,898,57.47,2213965,141693.76,3147,2293,0.91,125,35,0
1303,南亞         ,20130523,-2,-0.13,71161,4447.56,-2455,-153.44,2211541,138221.31,2314,4341,0.91,0,2,0
1303,南亞         ,20130524,-491,-30.69,70670,4416.88,1062,66.38,2213103,138318.94,6936,5182,0.9,0,491,0
1303,南亞         ,20130527,-5,-0.32,70665,4487.23,1301,82.61,2214580,140625.83,3357,2087,0.9,0,5,0
1303,南亞         ,20130528,-812,-50.75,69853,4365.81,-939,-58.69,2213666,138354.13,2199,2427,0.89,0,812,0.01
1303,南亞         ,20130529,0,0,69853,4463.61,237,15.14,2214306,141494.15,3890,3661,0.89,0,0,0
1303,南亞         ,20130530,-321,-19.93,69532,4317.94,-6238,-387.38,2208598,137153.94,1039,6672,0.89,0,321,0
1303,南亞         ,20130531,-911,-55.75,68621,4199.61,152,9.3,2206442,135034.25,10467,9472,0.87,2,913,0.01
1303,南亞         ,20130603,19,1.15,68640,4152.72,-896,-54.21,2205842,133453.44,2838,3756,0.87,19,0,0
1303,南亞         ,20130604,-544,-32.8,68096,4106.19,-3023,-182.29,2206393,133045.5,3457,6036,0.87,0,544,0
1303,南亞         ,20130605,-470,-27.97,67626,4023.75,-4445,-264.48,2202032,131020.9,1839,5897,0.86,0,470,0
1303,南亞         ,20130606,150,8.78,67776,3964.9,-4386,-256.58,2198064,128586.74,3064,7424,0.86,350,200,0
1303,南亞         ,20130607,319,18.98,68095,4051.65,-1192,-70.92,2197620,130758.39,2254,4111,0.87,319,0,0
1303,南亞         ,20130610,452,27.57,68547,4181.37,1904,116.14,2200134,134208.17,5077,3549,0.87,452,0,0
1303,南亞         ,20130611,619,37.39,69166,4177.63,718,43.37,2201062,132944.14,5203,4846,0.88,619,0,0
1303,南亞         ,20130613,-399,-23.42,68767,4036.62,-5396,-316.75,2192596,128705.39,3268,8307,0.88,60,459,0
1303,南亞         ,20130614,130,7.61,68897,4030.47,-1025,-59.96,2193337,128310.21,4293,5268,0.88,130,0,0
1303,南亞         ,20130617,156,9.17,69053,4060.32,-884,-51.98,2193072,128952.63,1847,2929,0.88,167,11,0
1303,南亞         ,20130618,330,19.31,69383,4058.91,-3481,-203.64,2189609,128092.13,2655,6567,0.88,337,7,0
1303,南亞         ,20130619,630,38.12,70013,4235.79,-852,-51.55,2190474,132523.68,3940,5186,0.89,634,4,0
1303,南亞         ,20130620,348,20.5,70361,4144.26,-3528,-207.8,2187172,128824.43,3414,7201,0.9,348,0,0
1303,南亞         ,20130621,-806,-46.35,69555,3999.41,-10080,-579.6,2177584,125211.08,25498,34421,0.89,191,997,0.01
1303,南亞         ,20130624,87,5.11,69642,4087.99,-1419,-83.3,2175427,127697.56,3177,5064,0.89,140,53,0
1303,南亞         ,20130625,590,34.52,70232,4108.57,751,43.93,2172904,127114.88,6695,6294,0.89,660,70,0
1303,南亞         ,20130626,-193,-11.29,70039,4097.28,-1556,-91.03,2169024,126887.9,7278,9125,0.89,59,252,0
1303,南亞         ,20130627,32,1.9,70071,4155.21,408,24.19,2166886,128496.34,3557,3377,0.89,40,8,0
1303,南亞         ,20130628,216,13.65,69120,4368.38,1104,69.77,2176469,137552.84,6295,5588,0.88,270,54,0
1303,南亞         ,20130701,-271,-16.45,68849,4179.13,-1224,-74.3,2173994,131961.44,4243,4915,0.88,0,271,0
1303,南亞         ,20130702,-705,-41.74,68144,4034.12,-715,-42.33,2173269,128657.52,2645,2632,0.87,0,705,0
1303,南亞         ,20130703,-118,-6.86,68026,3952.31,-973,-56.53,2172403,126216.61,2549,3549,0.87,123,241,0
1303,南亞         ,20130704,2,0.12,68028,3952.43,295,17.14,2172748,126236.66,2726,2601,0.87,45,43,0
1303,南亞         ,20130705,286,16.96,68314,4051.02,2933,173.93,2175836,129027.07,3531,1523,0.87,316,30,0
1303,南亞         ,20130708,-27,-1.56,68287,3940.16,-3066,-176.91,2172388,125346.79,1699,4467,0.87,99,126,0
1303,南亞         ,20130709,441,26.2,68728,4082.44,3551,210.93,2176054,129257.61,3637,777,0.88,441,0,0
1303,南亞         ,20130710,329,19.41,69057,4074.36,2492,147.03,2178478,128530.2,3186,917,0.88,356,27,0
1303,南亞         ,20130711,164,10.06,69221,4257.09,7129,438.43,2185199,134389.74,7707,661,0.88,173,9,0
1303,南亞         ,20130712,-46,-2.85,69175,4288.85,2396,148.55,2187186,135605.53,6840,4026,0.88,47,93,0
1303,南亞         ,20130715,-38,-2.43,69137,4424.77,8184,523.78,2195539,140514.5,10072,1740,0.88,74,112,0
1303,南亞         ,20130716,480,30.62,69617,4441.56,3771,240.59,2198396,140257.66,11611,7412,0.89,510,30,0
1303,南亞         ,20130717,84,5.43,69701,4502.68,9453,610.66,2207839,142626.4,15476,5459,0.89,283,199,0
1303,南亞         ,20130718,156,10.3,69857,4610.56,13083,863.48,2220669,146564.15,18923,6052,0.89,160,4,0
1303,南亞         ,20130719,268,17.69,70125,4628.25,5181,341.95,2225625,146891.25,10971,6169,0.89,303,35,0
1303,南亞         ,20130722,115,7.52,70240,4593.7,1052,68.8,2225729,145562.68,4390,3723,0.89,115,0,0
1303,南亞         ,20130723,3,0.2,70243,4636.04,5181,341.95,2229294,147133.4,6772,1781,0.89,3,0,0
1303,南亞         ,20130724,270,17.98,70513,4696.17,4201,279.79,2232459,148681.77,5573,1450,0.9,1247,977,0.01
1303,南亞         ,20130725,-894,-59.36,69619,4622.7,1821,120.91,2234222,148352.34,5347,2518,0.89,1,895,0.01
1303,南亞         ,20130726,-257,-16.58,69362,4473.85,910,58.7,2232035,143966.26,3883,2467,0.88,84,341,0
1303,南亞         ,20130729,-200,-12.76,69162,4412.54,2101,134.04,2234166,142539.79,2993,567,0.88,0,200,0
1303,南亞         ,20130730,-228,-14.82,68934,4480.71,2356,153.14,2236497,145372.3,3269,683,0.88,1,229,0
1303,南亞         ,20130731,-630,-39.69,68304,4303.15,-1814,-114.28,2225277,140192.45,2661,4062,0.87,0,630,0
1303,南亞         ,20130801,-579,-35.9,67725,4198.95,-403,-24.99,2224940,137946.28,1684,1427,0.86,0,579,0
1303,南亞         ,20130802,-200,-12.78,67525,4314.85,603,38.53,2225419,142204.27,1448,877,0.86,0,200,0
1303,南亞         ,20130805,-2,-0.13,67523,4307.97,-230,-14.67,2225205,141968.08,1280,1586,0.86,0,2,0
1303,南亞         ,20130806,134,8.44,67657,4262.39,-2586,-162.92,2222619,140025,764,3862,0.86,300,166,0
1303,南亞         ,20130807,-365,-22.19,67969,4132.52,-3263,-198.39,2221583,135072.25,1348,3708,0.87,0,365,0
1303,南亞         ,20130808,-38,-2.29,67931,4089.45,-5134,-309.07,2217708,133506.02,374,4725,0.87,0,38,0
1303,南亞         ,20130809,-479,-28.4,67452,3999.9,-4475,-265.37,2213570,131264.7,679,4338,0.86,0,479,0
1303,南亞         ,20130812,-264,-15.66,67188,3984.25,-1925,-114.15,2211520,131143.14,521,2485,0.86,0,264,0
1303,南亞         ,20130813,0,0,67188,4031.28,-547,-32.82,2210986,132659.16,1228,1762,0.86,0,0,0
1303,南亞         ,20130814,48,2.85,67236,3993.82,-3104,-184.38,2207201,131107.74,1062,4624,0.86,73,25,0
1303,南亞         ,20130815,-508,-29.71,66728,3903.59,-4830,-282.56,2203110,128881.94,783,4967,0.85,19,527,0
1303,南亞         ,20130816,-209,-12.33,66519,3924.62,-1537,-90.68,2201835,129908.27,3166,4714,0.85,30,239,0
1303,南亞         ,20130819,28,1.63,66547,3879.69,-1954,-113.92,2200065,128263.79,1737,3705,0.85,28,0,0
1303,南亞         ,20130820,33,1.9,66580,3841.67,-2808,-162.02,2197556,126798.98,1524,4296,0.85,33,0,0
1303,南亞         ,20130822,-6,-0.34,66574,3748.12,-8907,-501.46,2188899,123235.01,2943,11484,0.85,88,94,0
1303,南亞         ,20130823,-106,-6.01,66468,3768.74,-401,-22.74,2188480,124086.82,4023,4346,0.85,18,124,0
1303,南亞         ,20130826,34,1.93,66502,3777.31,-1637,-92.98,2186861,124213.7,1067,2937,0.85,34,0,0
1303,南亞         ,20130827,-154,-8.69,66348,3742.03,-3171,-178.84,2183690,123160.12,1631,4562,0.84,0,154,0
1303,南亞         ,20130828,-496,-28.07,65852,3727.22,-2480,-140.37,2181577,123477.26,1814,3492,0.84,23,519,0
1303,南亞         ,20130829,310,18.04,66162,3850.63,2497,145.33,2204818,128320.41,5356,3786,0.84,310,0,0
1303,南亞         ,20130830,-20,-1.17,66142,3875.92,-1558,-91.3,2202894,129089.59,5210,7115,0.84,8,28,0
1303,南亞         ,20130902,0,0,66142,3836.24,-2516,-145.93,2200890,127651.62,1711,3715,0.83,0,0,0
1303,南亞         ,20130903,0,-0.03,66142,3915.61,2014,119.23,2203176,130428.02,3975,1689,0.83,0,0,0
1303,南亞         ,20130904,708,42.62,66850,4024.37,2259,135.99,2205582,132776.04,3424,1726,0.84,708,0,0
1303,南亞         ,20130905,77,4.69,66927,4075.85,2066,125.82,2207844,134457.7,4059,2095,0.84,100,23,0
1303,南亞         ,20130906,209,12.6,67136,4048.3,652,39.32,2208789,133189.98,2523,1857,0.85,209,0,0
1303,南亞         ,20130909,6,0.37,67142,4129.23,5138,315.99,2213576,136134.92,5888,1427,0.85,10,4,0
1303,南亞         ,20130910,119,7.4,67261,4183.63,4920,306.02,2219117,138029.08,7617,2435,0.85,120,1,0
1303,南亞         ,20130911,333,20.88,67594,4238.14,4385,274.94,2224269,139461.67,8018,3789,0.85,355,22,0
1303,南亞         ,20130912,-100,-6.32,67494,4265.62,2427,153.39,2226797,140733.57,4337,1914,0.85,150,250,0
1303,南亞         ,20130913,75,4.63,67569,4175.76,237,14.65,2227319,137648.31,2015,1678,0.85,160,85,0
1303,南亞         ,20130914,-1022,-62.85,66547,4092.64,-328,-20.17,2226992,136960.01,695,0,0.84,0,1022,0.01
1303,南亞         ,20130916,-49,-3.12,66498,4235.92,5130,326.78,2234264,142322.62,5144,627,0.84,11,60,0
1303,南亞         ,20130917,162,10.4,66660,4279.57,-34,-2.18,2235134,143495.6,3164,2945,0.84,162,0,0
1303,南亞         ,20130918,-393,-24.96,66267,4207.95,-740,-46.99,2234334,141880.21,2889,3295,0.84,199,592,0
1303,南亞         ,20130923,-351,-22.29,65916,4185.67,-597,-37.91,2233684,141838.93,4836,5136,0.83,0,351,0
1303,南亞         ,20130924,-88,-5.58,65828,4173.5,770,48.82,2233462,141601.49,3004,1975,0.83,1,89,0
1303,南亞         ,20130925,-200,-12.7,65628,4167.38,821,52.13,2234709,141904.02,4914,3661,0.83,0,200,0
1303,南亞         ,20130926,-205,-12.76,65423,4069.31,-1664,-103.5,2233414,138918.35,1562,2654,0.82,3,208,0
1303,南亞         ,20130927,-103,-6.5,65320,4134.76,1594,100.9,2234991,141474.93,4090,2285,0.82,0,103,0
1303,南亞         ,20130930,-194,-12.05,66432,4132.07,-4645,-288.92,2231730,138813.61,1579,6032,0.84,4,198,0
1303,南亞         ,20131001,520,32.5,66952,4184.5,-33,-2.06,2231742,139483.88,1528,2182,0.84,582,62,0
1303,南亞         ,20131002,1377,88.01,68329,4366.22,1314,83.96,2233066,142692.92,1507,1598,0.86,1383,6,0.01
1303,南亞         ,20131003,2253,148.5,70582,4651.35,8501,560.22,2241771,147732.71,7767,1477,0.89,2254,1,0.01
1303,南亞         ,20131004,350,23.03,70932,4667.33,779,51.26,2242565,147560.78,2127,1799,0.89,350,0,0
1303,南亞         ,20131007,498,32.37,71430,4642.95,-1683,-109.4,2240882,145657.33,1336,3751,0.9,502,4,0
1303,南亞         ,20131008,365,23.91,71795,4702.57,2571,168.4,2244117,146989.66,2960,897,0.91,365,0,0
1303,南亞         ,20131009,258,16.85,72053,4705.06,789,51.52,2244997,146598.3,2963,2203,0.91,330,72,0
1303,南亞         ,20131011,-125,-8.2,71928,4718.48,1879,123.26,2245448,147301.39,2979,858,0.91,0,125,0
1303,南亞         ,20131014,59,3.84,71987,4686.35,581,37.82,2246224,146229.18,1641,737,0.91,82,23,0
1303,南亞         ,20131015,-125,-8.18,71862,4699.77,2611,170.76,2249351,147107.56,3527,751,0.91,81,206,0
1303,南亞         ,20131016,73,4.73,71935,4690.16,1432,93.37,2250795,146751.83,2103,762,0.91,95,22,0
1303,南亞         ,20131017,-120,-7.87,71815,4711.06,1666,109.29,2252605,147770.89,2211,849,0.91,2,122,0
1303,南亞         ,20131018,-1,-0.07,71814,4725.36,944,62.12,2254591,148352.09,1188,414,0.91,0,1,0
1303,南亞         ,20131021,350,23.05,72164,4748.39,1477,97.19,2256215,148458.95,1261,149,0.91,421,71,0
1303,南亞         ,20131022,-26,-1.72,72138,4761.11,764,50.42,2257137,148971.04,2147,1336,0.91,20,46,0
1303,南亞         ,20131023,-37,-2.43,72101,4729.83,249,16.33,2258064,148129,1798,1214,0.91,0,37,0
1303,南亞         ,20131024,0,0,72101,4801.93,901,60.01,2258360,150406.78,864,552,0.91,0,0,0
1303,南亞         ,20131025,-3,-0.2,72098,4772.89,-2590,-171.46,2255770,149331.97,790,2956,0.91,0,3,0
1303,南亞         ,20131028,-42,-2.78,72056,4777.31,2156,142.94,2257926,149700.49,2627,438,0.91,0,42,0
1303,南亞         ,20131029,-1,-0.07,72055,4813.27,3134,209.35,2261060,151038.81,4182,968,0.91,0,1,0
1303,南亞         ,20131030,104,6.96,72159,4827.44,2055,137.48,2263186,151407.14,2170,353,0.91,219,115,0
1303,南亞         ,20131031,-108,-7.24,72051,4827.42,1504,100.77,2264367,151712.59,3293,1678,0.91,0,108,0
1303,南亞         ,20131101,-34,-2.21,72017,4753.12,-150,-9.9,2264247,149440.3,549,723,0.91,0,34,0
1303,南亞         ,20131104,-57,-3.68,71960,4641.42,-1552,-100.1,2262850,145953.83,144,1437,0.91,0,57,0
1303,南亞         ,20131105,-274,-17.26,71686,4516.22,-1662,-104.71,2261151,142452.51,828,2253,0.9,0,274,0
1303,南亞         ,20131106,-94,-6,71592,4567.57,477,30.43,2261620,144291.36,1588,906,0.9,0,94,0
1303,南亞         ,20131107,-2,-0.13,71590,4588.92,-1041,-66.73,2260636,144906.77,918,1900,0.9,0,2,0
1303,南亞         ,20131108,0,0,71590,4517.33,-1580,-99.7,2259274,142560.19,582,2032,0.9,0,0,0
1303,南亞         ,20131111,0,0,71590,4503.01,-1485,-93.41,2257859,142019.33,797,2212,0.9,0,0,0
1303,南亞         ,20131112,0,0,71590,4624.71,900,58.14,2258572,145903.75,2466,1753,0.9,0,0,0
1303,南亞         ,20131113,-71,-4.47,71519,4505.7,-3666,-230.96,2254852,142055.68,939,4589,0.9,0,71,0
1303,南亞         ,20131114,0,0,71519,4512.85,-1696,-107.02,2252690,142144.74,756,2486,0.9,0,0,0
1303,南亞         ,20131115,-106,-6.82,71413,4591.86,1505,96.77,2253736,144915.22,2441,1166,0.9,0,106,0
1303,南亞         ,20131118,88,5.71,71501,4640.41,353,22.91,2253858,146275.38,686,483,0.9,88,0,0
1303,南亞         ,20131119,-170,-11.1,71331,4657.91,969,63.28,2254109,147193.32,1604,732,0.9,0,170,0
1303,南亞         ,20131120,200,12.94,71531,4628.06,-150,-9.71,2253984,145832.76,884,1039,0.9,300,100,0
1303,南亞         ,20131121,-253,-15.94,71278,4490.51,-4371,-275.37,2249397,141712.01,1036,5072,0.9,0,253,0
1303,南亞         ,20131122,292,18.57,71570,4551.85,-1601,-101.82,2247561,142944.88,1331,3178,0.9,293,1,0
1303,南亞         ,20131125,-458,-29.29,71112,4544.06,-79,-5.05,2247209,143596.66,1172,1121,0.9,0,458,0
1303,南亞         ,20131126,-634,-40.21,70478,4468.31,-1844,-116.91,2245365,142356.14,4929,6281,0.89,198,832,0.01
1303,南亞         ,20131127,-696,-44.55,69782,4466.05,527,33.73,2245843,143733.95,2171,1113,0.88,0,696,0
1303,南亞         ,20131128,-400,-25.84,69382,4482.08,2620,169.25,2248462,145250.65,3145,389,0.87,0,400,0
1303,南亞         ,20131129,-106,-6.87,69276,4489.08,2988,193.62,2250210,145813.61,3746,762,0.87,0,106,0
1303,南亞         ,20131202,43,2.81,69319,4533.46,1574,102.94,2251935,147276.55,1756,75,0.87,55,12,0
1303,南亞         ,20131203,-320,-20.8,68999,4484.94,115,7.48,2252239,146395.54,1777,1153,0.87,354,674,0.01
1303,南亞         ,20131204,-248,-16.54,68751,4578.82,5842,389.08,2257771,150367.55,6961,1273,0.87,365,613,0.01
1303,南亞         ,20131205,-181,-12.11,68570,4587.33,1733,115.94,2259882,151186.11,4491,2227,0.86,0,181,0
1303,南亞         ,20131206,0,0,68570,4559.9,-826,-54.93,2259101,150230.22,2038,2840,0.86,0,0,0
1303,南亞         ,20131209,330,22.57,68900,4712.76,4392,300.41,2263664,154834.62,5017,869,0.87,330,0,0
1303,南亞         ,20131210,0,0,68900,4740.32,555,38.18,2264410,155791.41,1794,1167,0.87,0,0,0
1303,南亞         ,20131211,-28,-1.95,68872,4793.49,2551,177.55,2267414,157812.01,3918,1086,0.87,0,28,0
1303,南亞         ,20131212,-18,-1.23,68854,4702.73,-884,-60.38,2266665,154813.22,1389,2201,0.87,0,18,0
1303,南亞         ,20131213,-114,-7.95,68740,4777.43,1630,113.29,2268489,157659.99,3116,1303,0.87,0,114,0
1303,南亞         ,20131216,-18,-1.25,68722,4734.95,-119,-8.2,2268343,156288.83,1375,1533,0.87,0,18,0
1303,南亞         ,20131217,-965,-66.1,67757,4641.35,-542,-37.13,2267824,155345.94,4142,3786,0.85,100,1065,0.01
1303,南亞         ,20131218,-658,-44.74,67099,4562.73,-1461,-99.35,2267106,154163.21,1184,1987,0.85,0,658,0
1303,南亞         ,20131219,0,0,67099,4616.41,2041,140.42,2269200,156120.96,3008,914,0.85,0,0,0
1303,南亞         ,20131220,-6,-0.41,67093,4562.32,-1714,-116.55,2267370,154181.16,4887,6711,0.85,52,58,0
1303,南亞         ,20131223,-17,-1.15,67076,4547.75,-306,-20.75,2266827,153690.87,1990,2490,0.85,0,17,0
1303,南亞         ,20131224,-30,-2.03,67046,4545.72,-151,-10.24,2265489,153600.15,1204,1362,0.85,0,30,0
1303,南亞         ,20131225,-23,-1.58,67023,4591.08,299,20.48,2265792,155206.75,746,420,0.85,0,23,0
1303,南亞         ,20131226,-79,-5.44,66944,4605.75,-126,-8.67,2265574,155871.49,146,295,0.84,0,79,0
1303,南亞         ,20131227,-777,-54,66167,4598.61,1256,87.29,2266830,157544.69,2982,949,0.83,20,797,0.01
1303,南亞         ,20131230,-827,-57.48,65340,4541.13,1811,125.86,2268352,157650.46,3339,1247,0.82,25,852,0.01
1303,南亞         ,20131231,-759,-52.3,62968,4338.5,1001,68.97,2265234,156074.62,2261,747,0.79,0,759,0
1303,南亞         ,20140102,-79,-5.39,62889,4289.03,20,1.36,2265254,154490.32,977,628,0.79,29,108,0
1303,南亞         ,20140103,-254,-17.09,62635,4215.34,-1877,-126.32,2263462,152330.99,658,2103,0.79,0,254,0
1303,南亞         ,20140106,236,15.84,62871,4218.64,-88,-5.9,2263555,151884.54,1422,1606,0.79,380,144,0
1303,南亞         ,20140107,-3,-0.2,62868,4212.16,6,0.4,2265233,151770.61,1710,1668,0.79,0,3,0
1303,南亞         ,20140108,-209,-14,62659,4198.15,-457,-30.62,2264628,151730.08,1249,1715,0.79,1,210,0
1303,南亞         ,20140109,-10,-0.67,62649,4184.95,-486,-32.46,2264153,151245.42,892,1441,0.79,0,10,0
1303,南亞         ,20140110,-240,-16.06,62409,4175.16,-586,-39.2,2263577,151433.3,1354,1651,0.79,0,240,0
1303,南亞         ,20140113,-106,-7.14,62303,4199.22,1496,100.83,2265073,152665.92,1672,536,0.79,0,106,0
1303,南亞         ,20140114,-733,-48.45,61570,4069.78,-2120,-140.13,2262748,149567.64,541,2160,0.78,4,737,0
1303,南亞         ,20140115,-1437,-95.83,60133,4010.87,2097,139.87,2265262,151092.98,4549,1373,0.76,0,1437,0.01
1303,南亞         ,20140116,0,0,60133,4028.91,-3039,-203.61,2262510,151588.17,1006,4250,0.76,0,0,0
1303,南亞         ,20140117,-1024,-67.58,59109,3901.19,-4001,-264.07,2258539,149063.57,206,3052,0.75,0,1024,0.01
1303,南亞         ,20140120,-661,-43.14,58448,3816.65,-3588,-234.3,2254951,147248.3,771,3770,0.74,0,661,0
1303,南亞         ,20140121,-413,-27.05,58035,3801.29,-1111,-72.77,2253824,147625.47,1531,2246,0.73,0,413,0
1303,南亞         ,20140122,-158,-10.48,57877,3837.25,1686,111.78,2255350,149529.7,3614,1734,0.73,0,158,0
1303,南亞         ,20140123,-62,-4.14,57815,3862.04,808,53.97,2256144,150710.42,2992,1972,0.73,0,62,0
1303,南亞         ,20140124,-22,-1.48,57793,3877.91,1580,106.02,2257724,151493.28,3271,2136,0.73,0,22,0
1303,南亞         ,20140127,-87,-5.75,57706,3814.37,-5885,-389,2250539,148760.63,3105,8916,0.73,0,87,0
1303,南亞         ,20140205,-401,-25.26,57305,3610.22,-12281,-773.7,2238813,141045.22,5960,17285,0.72,0,401,0
1303,南亞         ,20140206,-40,-2.52,57265,3607.7,-5159,-325.02,2233719,140724.3,4803,9541,0.72,0,40,0
1303,南亞         ,20140207,-61,-3.86,57204,3621.01,-3143,-198.95,2230636,141199.26,3201,6223,0.72,0,61,0
1303,南亞         ,20140210,-4,-0.25,57200,3637.92,321,20.42,2230953,141888.61,2215,1862,0.72,2,6,0
1303,南亞         ,20140211,-3,-0.19,57197,3632.01,-113,-7.18,2230839,141658.28,1050,1161,0.72,0,3,0
1303,南亞         ,20140212,806,51.75,58003,3723.79,-95,-6.1,2230693,143210.49,1984,2936,0.73,816,10,0.01
1303,南亞         ,20140213,466,29.7,58469,3724.48,148,9.43,2230823,142103.43,918,1214,0.74,486,20,0
1303,南亞         ,20140214,-10,-0.65,58459,3770.61,3033,195.63,2233728,144075.46,3976,1061,0.74,0,10,0
1303,南亞         ,20140217,-2198,-139.78,56261,3578.2,-5184,-329.7,2228515,141733.55,1525,4540,0.71,0,2198,0.01
1303,南亞         ,20140218,-30,-1.93,56231,3621.28,2374,152.89,2230987,143675.56,3177,774,0.71,0,30,0
1303,南亞         ,20140219,-581,-37.18,55650,3561.6,1097,70.21,2232046,142850.94,2075,435,0.7,198,779,0.01
1303,南亞         ,20140220,-417,-26.71,55233,3534.91,782,50.05,2232817,142900.29,2032,745,0.7,0,417,0
1303,南亞         ,20140221,-15,-0.97,55218,3572.6,2946,190.61,2236019,144670.43,4145,1153,0.7,14,29,0
1303,南亞         ,20140224,-728,-46.81,54490,3503.71,-495,-31.83,2235552,143745.99,1298,1027,0.69,0,728,0
1303,南亞         ,20140225,-106,-6.78,54384,3480.58,819,52.42,2236359,143126.98,1775,862,0.69,0,106,0
1303,南亞         ,20140226,-599,-38.6,53785,3463.75,1975,127.19,2238364,144150.64,3833,1239,0.68,150,749,0.01
1303,南亞         ,20140227,1318,85.54,55103,3576.18,2929,190.09,2241339,145462.9,3660,2022,0.69,1339,21,0.01
1303,南亞         ,20140303,1196,76.78,56299,3614.4,-1617,-103.81,2240371,143831.82,2499,5007,0.71,1423,227,0.01
1303,南亞         ,20140304,806,51.69,57105,3660.43,418,26.79,2241090,143653.87,1245,1633,0.72,845,39,0.01
1303,南亞         ,20140305,750,48.23,57855,3720.08,-1712,-110.08,2239389,143992.71,1076,3527,0.73,750,0,0
1303,南亞         ,20140306,-214,-13.7,57641,3689.02,-748,-47.87,2238659,143274.18,1372,1888,0.73,0,214,0
1303,南亞         ,20140307,-34,-2.19,57607,3709.89,2508,161.52,2241652,144362.39,2831,262,0.73,0,34,0
1303,南亞         ,20140310,91,5.88,57698,3727.29,745,48.13,2242396,144858.78,1832,1204,0.73,110,19,0
1303,南亞         ,20140311,-115,-7.48,57583,3742.9,896,58.24,2243406,145821.39,3012,1997,0.73,0,115,0
1303,南亞         ,20140312,-19,-1.22,57564,3707.12,-1938,-124.81,2241547,144355.63,953,2889,0.73,0,19,0
1303,南亞         ,20140313,-48,-3.06,57516,3675.27,-2731,-174.51,2239127,143080.22,2422,4914,0.73,0,48,0
1303,南亞         ,20140314,-21,-1.31,57495,3593.44,-4060,-253.75,2235126,139695.38,1172,5161,0.72,0,21,0
1303,南亞         ,20140317,-258,-16.41,57237,3640.27,372,23.66,2236333,142230.78,1973,1218,0.72,0,258,0
1303,南亞         ,20140318,-21,-1.37,57216,3673.27,1056,67.8,2237613,143654.75,3117,1780,0.72,0,21,0
1303,南亞         ,20140319,0,0,57216,3667.55,-1285,-82.37,2235174,143274.65,776,2811,0.72,0,0,0
1303,南亞         ,20140320,0,0,57216,3650.38,-3643,-232.42,2231548,142372.76,1686,5299,0.72,0,0,0
1303,南亞         ,20140321,-1,-0.06,57215,3644.6,-1642,-104.6,2230432,142078.52,3599,5497,0.72,0,1,0
1303,南亞         ,20140324,0,0,57215,3678.92,1963,126.22,2232381,143542.1,2488,580,0.72,0,0,0
1303,南亞         ,20140325,0,0,57215,3684.65,682,43.92,2233063,143809.26,2438,1708,0.72,0,0,0
1303,南亞         ,20140326,0,0,57215,3650.32,-1830,-116.75,2231233,142352.67,2493,4288,0.72,0,0,0
1303,南亞         ,20140327,0,0,57215,3707.53,1192,77.24,2232489,144665.29,6617,5360,0.72,0,0,0
1303,南亞         ,20140328,-5,-0.32,57210,3707.21,-1810,-117.29,2230816,144556.88,3809,5617,0.72,0,5,0
1303,南亞         ,20140331,0,0,51016,3290.53,-21,-1.35,2225386,143537.4,3394,3402,0.64,0,0,0
1303,南亞         ,20140401,-46,-2.95,50970,3267.18,-3595,-230.44,2221949,142426.93,2190,5669,0.64,0,46,0
1303,南亞         ,20140402,-60,-3.86,50910,3278.6,-617,-39.73,2222239,143112.19,2793,3359,0.64,0,60,0
1303,南亞         ,20140403,-102,-6.57,50808,3272.04,-707,-45.53,2222596,143135.18,2186,2874,0.64,0,102,0
1303,南亞         ,20140407,-30,-1.94,50778,3275.18,76,4.9,2221608,143293.72,4518,4407,0.64,0,30,0
1303,南亞         ,20140408,0,0,50778,3275.18,-781,-50.37,2220843,143244.37,2960,3741,0.64,0,0,0
1303,南亞         ,20140409,0,0,50778,3280.26,484,31.27,2221807,143528.73,3363,2841,0.64,0,0,0
1303,南亞         ,20140410,10,0.68,50788,3321.54,15,0.98,2221991,145318.21,1728,1959,0.64,10,0,0
1303,南亞         ,20140411,79,5.21,50867,3357.22,653,43.1,2222804,146705.06,1987,1456,0.64,79,0,0
1303,南亞         ,20140414,0,0,50867,3372.48,1276,84.6,2224080,147456.5,1918,616,0.64,0,0,0
1303,南亞         ,20140415,-1,-0.07,50866,3392.76,1510,100.72,2225839,148463.46,3593,2000,0.64,0,1,0
1303,南亞         ,20140416,43,2.87,50909,3400.72,1057,70.61,2227325,148785.31,3223,1705,0.64,45,2,0
1303,南亞         ,20140417,43,2.87,50952,3398.5,-1848,-123.26,2225833,148463.06,790,2335,0.64,45,2,0
1303,南亞         ,20140418,42,2.81,50994,3416.6,584,39.13,2226485,149174.5,761,211,0.64,45,3,0
1303,南亞         ,20140421,-5,-0.33,50989,3390.77,-388,-25.8,2226082,148034.45,53,461,0.64,0,5,0
1303,南亞         ,20140422,-5,-0.33,50984,3375.14,-1073,-71.03,2226597,147400.72,600,1668,0.64,0,5,0
1303,南亞         ,20140423,173,11.37,51157,3361.01,-1748,-114.84,2224116,146124.42,626,2375,0.65,175,2,0
1303,南亞         ,20140424,50,3.33,51207,3405.27,906,60.25,2225343,147985.31,1737,600,0.65,50,0,0
1303,南亞         ,20140425,0,0,51207,3359.18,-283,-18.56,2226073,146030.39,1019,1172,0.65,0,0,0
1303,南亞         ,20140428,0,0,51207,3354.06,431,28.23,2226482,145834.57,1866,1487,0.65,0,0,0
1303,南亞         ,20140429,-1,-0.07,51206,3374.48,-1528,-100.7,2225557,146664.21,854,2262,0.65,0,1,0
1303,南亞         ,20140430,36,2.38,51242,3387.1,2722,179.92,2228763,147321.23,7988,5248,0.65,46,10,0
1303,南亞         ,20140502,0,0,51242,3381.97,-361,-23.83,2228317,147068.92,1281,1644,0.65,0,0,0
1303,南亞         ,20140505,0,0,51242,3356.35,-1524,-99.82,2226900,145861.95,135,1550,0.65,0,0,0
1303,南亞         ,20140506,0,0,51242,3315.36,-1774,-114.78,2224280,143910.92,523,2073,0.65,0,0,0
1303,南亞         ,20140507,0,0,51242,3305.11,-3003,-193.69,2221609,143293.78,943,3614,0.65,0,0,0
1303,南亞         ,20140508,0,0,51242,3361.48,244,16.01,2221740,145746.14,1550,1090,0.65,0,0,0
1303,南亞         ,20140509,-3,-0.2,51239,3376.65,-461,-30.38,2221477,146395.33,1165,1420,0.65,0,3,0
1303,南亞         ,20140512,30,1.95,51269,3337.61,-1354,-88.15,2220206,144535.41,558,1912,0.65,30,0,0
1303,南亞         ,20140513,6,0.39,51275,3348.26,1521,99.32,2222205,145109.99,3555,1939,0.65,6,0,0
1303,南亞         ,20140514,8,0.53,51283,3369.29,1275,83.77,2223487,146083.1,4335,3173,0.65,8,0,0
1303,南亞         ,20140515,-2,-0.13,51281,3369.16,203,13.34,2223851,146107.01,853,607,0.65,0,2,0
1303,南亞         ,20140516,53,3.47,51334,3362.38,-250,-16.38,2223573,145644.03,1443,1830,0.65,53,0,0
1303,南亞         ,20140519,-5,-0.33,51329,3341.52,-346,-22.52,2222826,144705.97,1169,1682,0.65,0,5,0
1303,南亞         ,20140520,0,0,51329,3331.25,-1136,-73.73,2221598,144181.71,1943,3182,0.65,0,0,0
1303,南亞         ,20140521,0,0,51329,3367.18,953,62.52,2222488,145795.21,1379,499,0.65,0,0,0
1303,南亞         ,20140522,500,33.15,51829,3436.26,2132,141.35,2224466,147482.1,1922,444,0.65,500,0,0
1303,南亞         ,20140523,290,19.17,52119,3445.07,300,19.83,2224914,147066.82,2503,2531,0.66,290,0,0
1303,南亞         ,20140526,6,0.4,52125,3450.68,247,16.35,2225150,147304.93,622,392,0.66,8,2,0
1303,南亞         ,20140527,-17,-1.13,52108,3470.39,631,42.02,2225479,148216.9,704,144,0.66,3,20,0
1303,南亞         ,20140528,-2,-0.13,52106,3496.31,1820,122.12,2227337,149454.31,4148,2293,0.66,0,2,0
1303,南亞         ,20140529,-35,-2.37,52071,3525.21,2245,151.99,2229678,150949.2,3479,1104,0.66,0,35,0
1303,南亞         ,20140530,-8,-0.54,52063,3509.05,-2050,-138.17,2227713,150147.86,5038,7066,0.66,0,8,0
1303,南亞         ,20140603,-40,-2.71,52023,3521.96,845,57.21,2228606,150876.63,2438,1505,0.66,0,40,0
1303,南亞         ,20140604,36,2.44,52059,3534.81,-192,-13.04,2228366,151306.05,2760,3151,0.66,50,14,0
1303,南亞         ,20140605,-24,-1.62,52035,3512.36,-1538,-103.82,2226828,150310.89,1013,2454,0.66,0,24,0
1303,南亞         ,20140606,-2,-0.13,52033,3491.41,29,1.95,2226686,149410.63,745,726,0.66,0,2,0
1303,南亞         ,20140609,-2,-0.14,52031,3538.11,784,53.31,2227394,151462.79,1402,1083,0.66,0,2,0
1303,南亞         ,20140610,-15,-1.04,52016,3604.71,3809,263.96,2231272,154627.15,4151,546,0.66,0,15,0
1303,南亞         ,20140611,-21,-1.45,51995,3592.85,-832,-57.49,2230666,154139.02,969,1818,0.66,0,21,0
1303,南亞         ,20140612,-37,-2.54,51958,3569.51,613,42.11,2231295,153289.97,1530,821,0.66,0,37,0
1303,南亞         ,20140613,91,6.24,52049,3570.56,-34,-2.33,2231241,153063.13,958,1132,0.66,110,19,0
1303,南亞         ,20140616,-734,-50.28,51315,3515.08,-1174,-80.42,2227609,152591.22,921,1412,0.65,0,734,0
1303,南亞         ,20140617,-1186,-81.48,50129,3443.86,68,4.67,2216975,152306.18,2052,927,0.63,0,1186,0.01
1303,南亞         ,20140618,-1207,-84.01,48922,3404.97,5267,366.58,2219493,154476.71,7521,814,0.62,5,1212,0.01
1303,南亞         ,20140619,0,-0.03,48922,3419.65,1819,127.15,2217426,154998.08,2083,486,0.62,0,0,0
1303,南亞         ,20140620,-410,-28.34,48512,3357.03,-410,-28.37,2212159,153081.4,2663,2635,0.61,0,410,0
1303,南亞         ,20140623,981,68.28,49493,3444.71,2469,171.84,2212858,154014.92,2028,570,0.62,981,0,0.01
1303,南亞         ,20140624,1824,129.14,51317,3633.24,5494,388.98,2213410,156709.43,3780,624,0.65,1836,12,0.01
1303,南亞         ,20140625,293,20.74,51610,3653.99,1948,137.92,2215357,156847.28,2348,1151,0.65,300,7,0
1303,南亞         ,20140626,821,58.78,52431,3754.06,3084,220.81,2218365,158834.93,2700,561,0.66,821,0,0.01
1303,南亞         ,20140627,37,2.65,52468,3751.46,-212,-15.16,2216825,158502.99,1338,1516,0.66,37,0,0
1303,南亞         ,20140630,48,3.45,77245,5553.92,583,41.92,2241491,161163.2,1913,1683,0.97,69,21,0
1303,南亞         ,20140701,556,41.09,77801,5749.49,6284,464.39,2247704,166105.33,4956,313,0.98,556,0,0
1303,南亞         ,20140702,475,35.62,78276,5870.7,5224,391.8,2252928,168969.6,7138,968,0.99,479,4,0
1303,南亞         ,20140703,-157,-11.62,78119,5780.81,-368,-27.23,2244225,166072.65,940,1416,0.99,78,235,0
1303,南亞         ,20140704,118,8.67,78237,5750.42,1180,86.73,2245405,165037.27,2511,1556,0.99,118,0,0
1303,南亞         ,20140707,0,0,78237,5695.65,1943,141.45,2247348,163606.93,2241,840,0.99,0,0,0
1303,南亞         ,20140708,-16,-1.15,78221,5624.09,735,52.85,2248083,161637.17,1633,1418,0.99,0,16,0
1303,南亞         ,20140709,-39,-2.77,78182,5543.1,1737,123.15,2249820,159512.24,2254,156,0.99,30,69,0
1303,南亞         ,20140710,35,2.48,78217,5553.41,1389,98.62,2250776,159805.1,2389,1118,0.99,35,0,0
1303,南亞         ,20140711,298,21.61,78515,5692.34,2948,213.73,2253846,163403.83,4295,955,0.99,298,0,0
1303,南亞         ,20140714,97,6.98,78612,5660.06,1167,84.02,2254875,162351,3237,2137,0.99,97,0,0
1303,南亞         ,20140715,-49,-3.55,78563,5695.82,2087,151.31,2256977,163630.83,4153,1999,0.99,0,49,0
1303,南亞         ,20140716,420,30.2,78983,5678.88,895,64.35,2258118,162358.68,4056,2624,1,420,0,0
1303,南亞         ,20140717,68,4.9,79051,5691.67,2037,146.66,2268515,163333.08,2676,681,1,68,0,0
1303,南亞         ,20140718,279,20.09,79330,5711.76,456,32.83,2269554,163407.89,3122,1587,1,279,0,0
1303,南亞         ,20140721,0,0,79330,5711.76,1724,124.13,2271270,163531.44,3074,1272,1,0,0,0
1303,南亞         ,20140722,24,1.73,79354,5705.55,3485,250.57,2274674,163549.06,4372,879,1,24,0,0
1303,南亞         ,20140724,-94,-6.78,79260,5714.65,154,11.1,2275892,164091.81,1971,602,1,11,105,0
1303,南亞         ,20140725,7,0.5,79267,5667.59,1450,103.68,2277258,162823.95,1657,298,1,7,0,0
1303,南亞         ,20140728,0,0,79267,5683.44,3680,263.86,2280773,163531.42,3779,264,1,0,0,0
1303,南亞         ,20140729,119,8.57,79386,5715.79,6450,464.4,2287194,164677.97,7455,1102,1,119,0,0
1303,南亞         ,20140730,19,1.36,79405,5693.34,2867,205.56,2290127,164202.11,4451,1537,1,21,2,0
1303,南亞         ,20140731,73,5.12,79478,5571.41,-903,-63.3,2289001,160458.97,3451,4269,1,73,0,0
1303,南亞         ,20140801,-2,-0.14,79476,5491.79,1288,89,2290845,158297.39,2241,986,1,36,38,0
1303,南亞         ,20140804,-172,-11.59,79304,5345.09,-2622,-176.72,2287907,154204.93,2039,4488,1,0,172,0
1303,南亞         ,20140805,-866,-57.76,78438,5231.81,-5362,-357.65,2282486,152241.82,2937,7221,0.99,0,866,0.01
1303,南亞         ,20140806,11,0.76,78449,5436.52,2620,181.57,2285123,158359.02,4025,1328,0.99,11,0,0
1303,南亞         ,20140807,139,9.63,78588,5446.15,-1784,-123.63,2283468,158244.33,916,2711,0.99,139,0,0
1303,南亞         ,20140808,65,4.46,78653,5395.6,-534,-36.63,2284864,156741.67,1258,1856,0.99,65,0,0
1303,南亞         ,20140811,21,1.46,78674,5475.71,-879,-61.18,2283990,158965.7,366,1261,0.99,21,0,0
1303,南亞         ,20140812,60,4.19,78734,5503.51,-665,-46.48,2283623,159625.25,1938,2366,0.99,60,0,0
1303,南亞         ,20140813,221,15.69,78955,5605.81,2345,166.5,2286106,162313.53,2955,693,1,221,0,0
1303,南亞         ,20140814,29,2.05,78984,5576.27,-165,-11.65,2287326,161485.22,2034,1858,1,29,0,0
1303,南亞         ,20140815,46,3.25,79030,5579.52,1048,73.99,2288428,161563.02,2911,1868,1,63,17,0
1303,南亞         ,20140818,2,0.14,79032,5532.24,-127,-8.89,2291005,160370.35,836,920,1,2,0,0
1303,南亞         ,20140819,9,0.64,79041,5627.72,2478,176.43,2293513,163298.13,3392,893,1,9,0,0
1303,南亞         ,20140820,7,0.5,79048,5612.41,844,59.92,2295083,162950.89,3904,2613,1,7,0,0
1303,南亞         ,20140821,38,2.69,79086,5591.38,1091,77.13,2296146,162337.52,1952,927,1,38,0,0
1303,南亞         ,20140822,0,0,79086,5694.19,6021,433.51,2302323,165767.26,7234,997,1,0,0,0
1303,南亞         ,20140825,0,0,79086,5694.19,1984,142.85,2304163,165899.74,2536,618,1,0,0,0
1303,南亞         ,20140826,32,2.3,79118,5696.5,1014,73.01,2305197,165974.18,1547,545,1,32,0,0
1303,南亞         ,20140827,3,0.22,79121,5720.45,3544,256.23,2308685,166917.93,5150,1618,1,3,0,0
1303,南亞         ,20140828,66,4.77,79187,5717.3,2789,201.37,2316910,167280.9,3398,679,1,66,0,0
1303,南亞         ,20140829,1,0.07,79188,5582.75,-619,-43.64,2320220,163575.51,3321,3893,1,1,0,0
1303,南亞         ,20140901,0,0,79188,5646.1,2467,175.9,2322599,165601.31,3971,1505,1,0,0,0
1303,南亞         ,20140902,171,12.12,79359,5626.55,601,42.61,2323421,164730.55,2411,1759,1,171,0,0
1303,南亞         ,20140903,26,1.85,79385,5636.34,2382,169.12,2336103,165863.31,3170,777,1,26,0,0
1303,南亞         ,20140904,497,35.14,79882,5647.66,-74,-5.23,2336117,165163.47,1124,1607,1.01,521,24,0
1303,南亞         ,20140905,23,1.62,79905,5633.3,966,68.1,2337659,164804.96,1250,302,1.01,23,0,0
1303,南亞         ,20140909,100,7.06,80005,5648.35,1327,93.69,2338986,165132.41,1322,95,1.01,100,0,0
1303,南亞         ,20140910,-400,-27.56,79605,5484.78,-3611,-248.8,2336906,161012.82,709,3891,1,0,400,0
1303,南亞         ,20140911,-983,-67.34,78622,5385.61,-675,-46.24,2336286,160035.59,1534,1171,0.99,110,1093,0.01
1303,南亞         ,20140912,-16,-1.08,78606,5329.49,-45,-3.05,2336510,158415.38,1313,1074,0.99,34,50,0
1303,南亞         ,20140915,-422,-28.86,78184,5347.79,1238,84.68,2337048,159854.08,3656,2086,0.99,33,455,0
1303,南亞         ,20140916,-234,-15.87,77950,5285.01,-1291,-87.53,2335705,158360.8,1544,2654,0.98,16,250,0
1303,南亞         ,20140917,51,3.47,78001,5311.87,-677,-46.1,2334098,158952.07,4912,5699,0.98,51,0,0
1303,南亞         ,20140918,-295,-20.24,77706,5330.63,1685,115.59,2335635,160224.56,3583,1605,0.98,20,315,0
1303,南亞         ,20140919,-720,-49.18,76986,5258.14,-629,-42.96,2334651,159456.66,1953,1899,0.97,35,755,0
1303,南亞         ,20140922,72,4.83,77058,5170.59,-2286,-153.39,2332386,156503.1,2596,4933,0.97,72,0,0
1303,南亞         ,20140923,16,1.06,77074,5086.88,-2728,-180.05,2329264,153731.42,1566,4226,0.97,16,0,0
1303,南亞         ,20140924,-342,-22.54,76732,5056.64,60,3.95,2329136,153490.06,2906,2533,0.97,35,377,0
1303,南亞         ,20140925,-231,-15.32,76501,5072.02,1183,78.43,2333227,154692.95,4047,2564,0.96,0,231,0
1303,南亞         ,20140926,-20,-1.37,76481,5162.47,4230,285.53,2338391,157841.39,5858,1675,0.96,0,20,0
1303,南亞         ,20140929,-90,-6.09,76391,5171.67,-1213,-82.12,2338508,158316.99,6281,7424,0.96,0,90,0
1303,南亞         ,20140930,-632,-42.09,48089,3202.73,-1074,-71.53,2308899,153772.67,6110,6753,0.61,44,676,0
1303,南亞         ,20141001,-586,-38.91,47503,3154.2,-2086,-138.51,2306596,153157.97,4126,5632,0.6,0,586,0
1303,南亞         ,20141002,0,0,47503,3173.2,-320,-21.38,2306275,154059.17,3665,4687,0.6,0,0,0
1303,南亞         ,20141003,-334,-22.58,47169,3188.62,-2099,-141.89,2304734,155800.02,1733,3574,0.59,40,374,0
1303,南亞         ,20141006,12,0.8,47181,3132.82,-3838,-254.84,2302640,152895.3,2272,5946,0.59,12,0,0
1303,南亞         ,20141007,-241,-15.86,46940,3088.65,-668,-43.95,2302416,151498.97,3974,4225,0.59,3,244,0
1303,南亞         ,20141008,-85,-5.48,46855,3022.15,-2841,-183.24,2299742,148333.36,4370,6782,0.59,3,88,0
1303,南亞         ,20141009,-64,-4.16,46791,3041.42,284,18.46,2300235,149515.28,2174,1820,0.59,0,64,0
1303,南亞         ,20141013,0,0,46791,2980.59,186,11.85,2300317,146530.19,2570,2396,0.59,0,0,0
1303,南亞         ,20141014,-60,-3.82,46731,2976.76,6,0.38,2300366,146533.31,2919,2839,0.59,1,61,0
1303,南亞         ,20141015,-449,-27.3,46282,2813.95,-4669,-283.88,2295947,139593.58,5934,10030,0.58,8,457,0
1303,南亞         ,20141016,-99,-5.96,46183,2780.22,-3571,-214.97,2292557,138011.93,2762,6266,0.58,0,99,0
1303,南亞         ,20141017,-98,-5.77,46085,2700.58,-6850,-401.41,2285304,133918.81,11800,18488,0.58,5,103,0
1303,南亞         ,20141020,-66,-3.9,46019,2719.72,-1011,-59.75,2283820,134973.76,2224,3138,0.58,0,66,0
1303,南亞         ,20141021,-28,-1.66,45991,2727.27,-1533,-90.91,2281941,135319.1,1203,2702,0.58,22,50,0
1303,南亞         ,20141022,-490,-29.6,45501,2748.26,-514,-31.05,2281719,137815.83,1499,1490,0.57,0,490,0
1303,南亞         ,20141023,-581,-35.15,44920,2717.66,-800,-48.4,2280208,137952.58,1237,1456,0.57,34,615,0
1303,南亞         ,20141024,-262,-15.8,44658,2692.88,-2300,-138.69,2277976,137361.95,1204,3174,0.56,41,303,0
1303,南亞         ,20141027,-604,-36.48,44054,2660.86,-582,-35.15,2276897,137524.58,1516,1596,0.56,0,604,0
1303,南亞         ,20141028,-820,-50.27,43234,2650.24,378,23.17,2276713,139562.51,5006,4001,0.55,0,820,0.01
1303,南亞         ,20141029,9,0.56,43243,2676.74,-3299,-204.21,2273791,140747.66,2973,6281,0.55,9,0,0
1303,南亞         ,20141030,263,16.46,43506,2723.48,-65,-4.07,2273776,142338.38,2259,2611,0.55,263,0,0
1303,南亞         ,20141031,-5,-0.31,43501,2736.21,-1038,-65.29,2272477,142938.8,2749,3770,0.55,0,5,0
1303,南亞         ,20141103,-7,-0.44,43494,2757.52,18,1.14,2272602,144082.97,1446,1413,0.55,0,7,0
1303,南亞         ,20141104,0,0,43494,2757.52,883,55.98,2273213,144121.7,1900,1039,0.55,0,0,0
1303,南亞         ,20141105,0,0,43494,2700.98,-1379,-85.64,2271931,141086.92,1510,2932,0.55,0,0,0
1303,南亞         ,20141106,-24,-1.5,43470,2712.53,701,43.74,2272943,141831.64,1793,1341,0.55,0,24,0
1303,南亞         ,20141107,-26,-1.6,43444,2676.15,-669,-41.21,2272274,139972.08,508,1098,0.55,0,26,0
1303,南亞         ,20141110,0,0,43444,2771.73,3507,223.75,2276000,145208.8,4323,1068,0.55,0,0,0
1303,南亞         ,20141111,16,1.01,43460,2746.67,329,20.79,2276373,143866.77,1640,1372,0.55,37,21,0
1303,南亞         ,20141112,18,1.11,43478,2673.9,-3016,-185.48,2273509,139820.8,1028,4094,0.55,18,0,0
1303,南亞         ,20141113,0,0,43478,2708.68,-325,-20.25,2272957,141605.22,1859,2093,0.55,0,0,0
1303,南亞         ,20141114,0,0,43478,2699.98,-721,-44.77,2272051,141094.37,1362,2062,0.55,0,0,0
1303,南亞         ,20141117,-50,-3.07,43428,2662.14,-1862,-114.14,2270127,139158.79,682,2515,0.55,0,50,0
1303,南亞         ,20141118,-11,-0.68,43417,2687.51,757,46.86,2270766,140560.42,2629,2056,0.55,0,11,0
1303,南亞         ,20141119,0,0,43417,2687.51,256,15.85,2273295,140716.96,6686,6518,0.55,0,0,0
1303,南亞         ,20141120,7,0.44,43424,2731.37,1991,125.23,2275110,143104.42,2625,1251,0.55,7,0,0
1303,南亞         ,20141121,-15,-0.95,43409,2756.47,1454,92.33,2276582,144562.96,2848,1384,0.55,12,27,0
1303,南亞         ,20141124,0,0,43409,2782.52,855,54.81,2277756,146004.16,2350,1738,0.55,0,0,0
1303,南亞         ,20141125,-2,-0.13,43407,2752,-727,-46.09,2277030,144363.7,5548,5893,0.55,1,3,0
1303,南亞         ,20141126,-2,-0.13,43405,2782.26,-863,-55.32,2275939,145887.69,1202,2033,0.55,0,2,0
1303,南亞         ,20141127,-6,-0.39,43399,2799.24,631,40.7,2276588,146839.93,1349,710,0.55,0,6,0
1303,南亞         ,20141128,0,0,43399,2812.26,1239,80.29,2276762,147534.18,2856,1511,0.55,0,0,0
1303,南亞         ,20141201,0,0,43399,2738.48,-3078,-194.22,2273745,143473.31,697,3741,0.55,0,0,0
1303,南亞         ,20141202,0,0,43399,2725.46,-1900,-119.32,2272333,142702.51,2328,4244,0.55,0,0,0
1303,南亞         ,20141203,-75,-4.83,43324,2785.73,537,34.53,2272852,146144.38,1943,1351,0.55,0,75,0
1303,南亞         ,20141204,0,0,43324,2833.39,1909,124.85,2274771,148770.02,6266,4421,0.55,0,0,0
1303,南亞         ,20141205,-27,-1.78,43297,2853.27,729,48.04,2275500,149955.45,2029,1292,0.55,0,27,0
1303,南亞         ,20141208,-5,-0.33,43292,2822.64,99,6.45,2275544,148365.47,1193,1036,0.55,0,5,0
1303,南亞         ,20141209,0,0,43292,2788,-641,-41.28,2274890,146502.92,790,1442,0.55,0,0,0
1303,南亞         ,20141210,-38,-2.41,43254,2742.3,-3086,-195.65,2271792,144031.61,1208,4315,0.55,0,38,0
1303,南亞         ,20141211,120,7.49,43374,2710.88,-2267,-141.69,2269780,141861.25,1593,3925,0.55,122,2,0
1303,南亞         ,20141212,0,0,43374,2689.19,-2574,-159.59,2267206,140566.77,593,3227,0.55,0,0,0
1303,南亞         ,20141215,-85,-5.09,43289,2601.67,-4367,-262.46,2262961,136003.96,1757,5764,0.55,0,85,0
1303,南亞         ,20141216,-76,-4.61,43213,2623.03,-1106,-67.13,2261839,137293.63,3578,4590,0.54,5,81,0
1303,南亞         ,20141217,1328,78.62,44541,2636.83,-6097,-360.94,2255945,133551.94,2204,9586,0.56,1499,171,0.01
1303,南亞         ,20141218,-49,-2.94,44492,2669.52,-3205,-192.3,2252567,135154.02,1414,4542,0.56,0,49,0
1303,南亞         ,20141219,40,2.4,44532,2676.37,-676,-40.63,2250703,135267.25,3382,4215,0.56,165,125,0
1303,南亞         ,20141222,0,0,44532,2743.17,1008,62.09,2251444,138688.95,1678,726,0.56,0,0,0
1303,南亞         ,20141223,750,46.8,45282,2825.6,909,56.72,2252411,140550.45,1394,1228,0.57,750,0,0
1303,南亞         ,20141224,1678,108.57,46960,3038.31,2505,162.07,2254267,145851.07,1667,1110,0.59,1678,0,0.01
1303,南亞         ,20141225,-90,-5.79,46870,3013.74,-17,-1.09,2254258,144948.79,534,274,0.59,0,90,0
1303,南亞         ,20141226,81,5.25,46951,3042.42,916,59.36,2255385,146148.95,1245,400,0.59,81,0,0
1303,南亞         ,20141227,0,0,46951,3028.34,118,7.61,2255485,145478.78,0,1,0.59,0,0,0
1303,南亞         ,20141229,-10,-0.65,46941,3069.94,2340,153.04,2258112,147680.52,3242,931,0.59,0,10,0
1303,南亞         ,20141230,62,4.01,47003,3036.39,-37,-2.39,2258138,145875.71,1924,1994,0.59,67,5,0
1303,南亞         ,20141231,110,7.21,45566,2984.57,-73,-4.78,2257396,147859.44,1170,1187,0.57,113,3,0
1303,南亞         ,20150105,35,2.24,45601,2913.9,-2322,-148.38,2255296,144113.41,1313,3835,0.57,35,0,0
1303,南亞         ,20150106,-800,-49.44,44801,2768.7,-4324,-267.22,2250565,139084.92,1671,5166,0.56,0,800,0.01
1303,南亞         ,20150107,-8,-0.49,44793,2736.85,-4343,-265.36,2246192,137242.33,1356,5535,0.56,35,43,0
1303,南亞         ,20150108,1416,89.49,46209,2920.41,2456,155.22,2248603,142111.71,2563,1847,0.58,1416,0,0.01
1303,南亞         ,20150109,1586,101.82,47795,3068.44,595,38.2,2249242,144401.34,1037,1682,0.6,1586,0,0.01
1303,南亞         ,20150112,1044,66.61,48839,3115.93,-1772,-113.05,2247588,143396.11,646,3501,0.62,1044,0,0.01
1303,南亞         ,20150113,771,50.12,49610,3224.65,1083,70.39,2248672,146163.68,3437,3102,0.63,772,1,0
1303,南亞         ,20150114,479,30.85,50089,3225.73,-2689,-173.17,2245615,144617.61,1845,4899,0.63,483,4,0
1303,南亞         ,20150115,404,25.98,50493,3246.7,-1186,-76.26,2244429,144316.78,1217,2769,0.64,404,0,0
1303,南亞         ,20150116,153,9.62,50646,3185.63,-4040,-254.12,2240413,140921.98,1328,5435,0.64,153,0,0
1303,南亞         ,20150119,225,14.36,50871,3245.57,2642,168.56,2243121,143111.12,3448,1013,0.64,225,0,0
1303,南亞         ,20150120,25,1.62,50896,3303.15,3218,208.85,2246490,145797.2,4338,1465,0.64,25,0,0
1303,南亞         ,20150121,80,5.23,50976,3333.83,2891,189.07,2248775,147069.89,3532,708,0.64,84,4,0
1303,南亞         ,20150122,685,44.94,51661,3388.96,1672,109.68,2250603,147639.56,2741,2190,0.65,736,51,0
1303,南亞         ,20150123,72,4.74,51733,3409.2,2583,170.22,2253629,148514.15,3510,889,0.65,79,7,0
1303,南亞         ,20150126,0,0,51733,3404.03,69,4.54,2253881,148305.37,1178,1388,0.65,0,0,0
1303,南亞         ,20150127,0,0,51733,3393.68,1176,77.15,2254973,147926.23,2388,1236,0.65,0,0,0
1303,南亞         ,20150128,100,6.56,51833,3400.24,3237,212.35,2258210,148138.58,3863,647,0.65,100,0,0
1303,南亞         ,20150129,-914,-60.05,50919,3345.38,-1253,-82.32,2256903,148278.53,2941,3111,0.64,660,1574,0.01
1303,南亞         ,20150130,-57,-3.62,50862,3229.74,-4247,-269.68,2251798,142989.17,3676,7840,0.64,31,88,0
1303,南亞         ,20150202,1731,113.9,52593,3460.62,4999,328.93,2257563,148547.65,3868,414,0.66,1731,0,0.01
1303,南亞         ,20150203,3363,225.99,55956,3760.24,7622,512.2,2265141,152217.48,4023,1703,0.71,3363,0,0.02
1303,南亞         ,20150204,1397,95.69,57353,3928.68,6801,465.87,2272302,155652.69,7905,2626,0.72,1398,1,0.01
1303,南亞         ,20150205,62,4.25,57415,3932.93,4978,340.99,2277227,155990.05,6850,1935,0.72,62,0,0
1303,南亞         ,20150206,369,25.24,57784,3952.43,4289,293.37,2281482,156053.37,5575,1333,0.73,370,1,0
1303,南亞         ,20150209,111,7.58,57895,3954.23,6084,415.54,2287566,156240.76,6990,1033,0.73,111,0,0
1303,南亞         ,20150210,0,0,57895,3936.86,3946,268.33,2291512,155822.82,5497,1410,0.73,0,0,0
1303,南亞         ,20150211,345,23.01,58240,3884.61,1957,130.53,2293400,152969.78,4365,2871,0.73,345,0,0
1303,南亞         ,20150212,-327,-21.65,57913,3833.84,691,45.74,2293911,151856.91,3485,2252,0.73,0,327,0
1303,南亞         ,20150213,555,37.8,58468,3981.67,5140,350.03,2299051,156565.37,8848,4110,0.74,577,22,0
1303,南亞         ,20150224,-680,-47.12,57788,4004.71,5722,396.53,2304731,159717.86,8163,1526,0.73,173,853,0.01
1303,南亞         ,20150225,1512,105.08,59300,4121.35,5096,354.17,2310252,160562.51,4537,1045,0.75,1552,40,0.01
1303,南亞         ,20150226,-206,-14.05,59094,4030.21,584,39.83,2309810,157529.04,3952,3149,0.75,0,206,0
1303,南亞         ,20150302,-227,-15.48,58867,4014.73,696,47.47,2311734,157660.26,4529,2378,0.74,90,317,0
1303,南亞         ,20150303,192,13.15,59059,4045.54,3146,215.5,2314901,158570.72,5211,2236,0.74,195,3,0
1303,南亞         ,20150304,-207,-14.08,58852,4001.94,579,39.37,2315478,157452.5,1618,834,0.74,4,211,0
1303,南亞         ,20150305,91,6.15,58943,3984.55,465,31.43,2316182,156573.9,2468,1855,0.74,100,9,0
1303,南亞         ,20150306,8,0.55,58951,4073.51,3473,239.98,2320187,160324.92,6604,3164,0.74,78,70,0
1303,南亞         ,20150309,128,8.72,59079,4023.28,256,17.43,2320570,158030.82,2675,2420,0.74,136,8,0
1303,南亞         ,20150310,46,3.11,59125,4002.76,91,6.16,2320599,157104.55,3206,3132,0.75,47,1,0
1303,南亞         ,20150311,190,12.75,59315,3980.04,-846,-56.77,2319739,155654.49,2552,3602,0.75,191,1,0
1303,南亞         ,20150312,-19,-1.31,59296,4020.27,2347,159.13,2322217,157446.31,4591,2110,0.75,0,19,0
1303,南亞         ,20150313,191,12.82,59487,3991.58,-871,-58.44,2321364,155763.52,3617,4662,0.75,191,0,0
1303,南亞         ,20150316,-45,-3,59442,3964.78,851,56.76,2322129,154886,2528,1700,0.75,0,45,0
1303,南亞         ,20150317,-5,-0.34,59437,4012,2838,191.57,2325247,156954.17,4107,1267,0.75,0,5,0
1303,南亞         ,20150318,-15,-1.03,59422,4064.46,5496,375.93,2331442,159470.63,7524,1999,0.75,0,15,0
1303,南亞         ,20150319,-481,-33.14,58941,4061.03,3695,254.59,2335208,160895.83,6516,2513,0.74,19,500,0
1303,南亞         ,20150320,-1259,-85.49,57682,3916.61,-1838,-124.8,2333520,158446.01,4569,5531,0.73,7,1266,0.01
1303,南亞         ,20150323,-35,-2.39,57647,3943.05,277,18.95,2333713,159625.97,1063,738,0.73,475,510,0.01
1303,南亞         ,20150324,-638,-43.58,57009,3893.71,-678,-46.31,2332824,159331.88,2139,2162,0.72,0,638,0
1303,南亞         ,20150325,-15,-1.02,56994,3869.89,795,53.98,2333965,158476.22,2528,1372,0.72,0,15,0
1303,南亞         ,20150326,462,31.88,57456,3964.46,4432,305.81,2338071,161326.9,5183,1358,0.72,462,0,0
1303,南亞         ,20150327,-169,-11.59,57287,3929.89,417,28.61,2338495,160420.76,4006,3480,0.72,0,169,0
1303,南亞         ,20150330,34,2.35,57321,3960.88,2247,155.27,2340782,161748.04,4123,1916,0.72,34,0,0
1303,南亞         ,20150331,90,6.26,52787,3668.7,1748,121.49,2337834,162479.46,4514,2823,0.67,92,2,0
1303,南亞         ,20150401,86,5.89,52873,3621.8,-828,-56.72,2337011,160085.25,3681,4561,0.67,86,0,0
1303,南亞         ,20150402,120,8.34,52993,3683.01,3461,240.54,2340473,162662.87,4310,969,0.67,120,0,0
1303,南亞         ,20150407,34,2.38,53027,3711.89,2007,140.49,2342445,163971.15,2422,1077,0.67,40,6,0
1303,南亞         ,20150408,-112,-7.69,52915,3635.26,-2749,-188.86,2339586,160729.56,6979,9592,0.67,0,112,0
1303,南亞         ,20150409,-6,-0.42,52909,3666.59,1685,116.77,2341271,162250.08,3094,1139,0.67,0,6,0
1303,南亞         ,20150410,-5,-0.35,52904,3703.28,3862,270.34,2345161,164161.27,3645,305,0.67,0,5,0
1303,南亞         ,20150413,1679,120.05,54583,3902.68,7818,558.99,2352990,168238.79,7304,1791,0.69,1679,0,0.01
1303,南亞         ,20150414,793,57.02,55376,3981.53,3634,261.28,2356595,169439.18,8649,5813,0.7,805,12,0.01
1303,南亞         ,20150415,131,9.46,55507,4007.61,5231,377.68,2361836,170524.56,13753,8236,0.7,141,10,0
1303,南亞         ,20150416,-1099,-80.23,54408,3971.78,8730,637.29,2370566,173051.32,11828,2053,0.69,189,1288,0.01
1303,南亞         ,20150417,-167,-12.24,54241,3975.87,6746,494.48,2377318,174257.41,10580,3561,0.68,302,469,0
1303,南亞         ,20150420,95,6.96,54336,3982.83,3588,263,2380959,174524.29,5293,1772,0.69,101,6,0
1303,南亞         ,20150421,285,21.32,54621,4085.65,6230,466,2387328,178572.13,7348,1757,0.69,297,12,0
1303,南亞         ,20150422,345,25.98,54966,4138.94,5798,436.59,2393348,180219.1,13269,7516,0.69,500,155,0
1303,南亞         ,20150423,54,4.15,55020,4225.54,8846,679.37,2401992,184472.99,10713,1485,0.69,54,0,0
1303,南亞         ,20150424,250,19.75,55270,4366.33,11282,891.28,2413358,190655.28,14293,3557,0.7,253,3,0
1303,南亞         ,20150427,75,5.87,55345,4327.98,2676,209.26,2415994,188930.73,7111,4950,0.7,153,78,0
1303,南亞         ,20150428,-289,-22.46,55056,4277.85,3694,287.02,2420066,188039.13,6222,2425,0.69,125,414,0
1303,南亞         ,20150429,317,24.38,55373,4258.18,6053,465.48,2425854,186548.17,7179,1997,0.7,329,12,0
1303,南亞         ,20150430,4,0.3,55377,4180.96,2222,167.76,2425974,183161.04,8981,6805,0.7,7,3,0
1303,南亞         ,20150504,-24,-1.84,55353,4234.5,3709,283.74,2429700,185872.05,4390,640,0.7,100,124,0
1303,南亞         ,20150505,291,22.35,55644,4273.46,3909,300.21,2433686,186907.08,4329,644,0.7,294,3,0
1303,南亞         ,20150506,-1106,-84.83,54538,4183.06,2359,180.94,2435891,186832.84,5845,2236,0.69,7,1113,0.01
1303,南亞         ,20150507,-498,-36.95,54040,4009.77,-2209,-163.91,2433597,180572.9,2657,4497,0.68,0,498,0
1303,南亞         ,20150508,-288,-21.69,53752,4047.53,2280,171.68,2436285,183452.26,4591,1647,0.68,0,288,0
1303,南亞         ,20150511,33,2.47,53785,4017.74,1364,101.89,2438157,182130.33,3031,1305,0.68,33,0,0
1303,南亞         ,20150512,440,33.48,54225,4126.52,4505,342.83,2442628,185883.99,5269,1173,0.68,475,35,0
1303,南亞         ,20150513,-69,-5.19,54156,4072.53,319,23.99,2443059,183718.04,2743,2292,0.68,90,159,0
1303,南亞         ,20150514,6,0.44,54162,3970.07,-827,-60.62,2443644,179119.11,3296,4015,0.68,6,0,0
1303,南亞         ,20150515,-363,-26.35,53799,3905.81,-673,-48.86,2443152,177372.84,2024,2163,0.68,0,363,0
1303,南亞         ,20150518,0,0,53799,3954.23,1121,82.39,2444195,179648.33,2235,910,0.68,0,0,0
1303,南亞         ,20150519,0,0,53799,3986.51,1462,108.33,2445681,181224.96,2322,865,0.68,0,0,0
1303,南亞         ,20150520,-292,-21.17,53507,3879.26,-857,-62.13,2445455,177295.49,3229,3093,0.67,6,298,0
1303,南亞         ,20150521,-179,-13,53328,3871.61,-3006,-218.24,2442605,177333.12,3223,5936,0.67,124,303,0
1303,南亞         ,20150522,-68,-5,53260,3914.61,3879,285.11,2446806,179840.24,5625,1366,0.67,0,68,0
1303,南亞         ,20150525,-69,-5.04,53191,3888.26,-1482,-108.33,2445422,178760.35,875,2190,0.67,0,69,0
1303,南亞         ,20150526,-952,-69.59,52239,3818.67,-645,-47.15,2444810,178715.61,1203,863,0.66,0,952,0.01
1303,南亞         ,20150527,-125,-9.21,52114,3840.8,611,45.03,2445422,180227.6,2424,1677,0.66,0,125,0
1303,南亞         ,20150528,-210,-15.2,51904,3757.85,-2824,-204.46,2442549,176840.55,3139,5803,0.65,71,281,0
1303,南亞         ,20150529,-115,-8.35,51789,3759.88,-371,-26.93,2442226,177305.61,6204,6421,0.65,0,115,0
1303,南亞         ,20150601,-83,-5.98,51706,3722.83,-2021,-145.51,2440239,175697.21,885,2799,0.65,0,83,0
1303,南亞         ,20150602,-35,-2.56,51671,3777.15,607,44.37,2440844,178425.7,3382,2753,0.65,0,35,0
1303,南亞         ,20150603,1054,77.15,52725,3859.47,-54,-3.95,2440971,178679.08,2207,3359,0.66,1210,156,0.01
1303,南亞         ,20150604,-21,-1.51,52704,3784.15,-4614,-331.29,2437680,175025.42,2264,6709,0.66,0,21,0
1303,南亞         ,20150605,-5,-0.36,52699,3773.25,-3804,-272.37,2434103,174281.77,939,4543,0.66,1,6,0
1303,南亞         ,20150608,0,0,52699,3836.49,-2371,-172.61,2431676,177026.01,1820,4122,0.66,0,0,0
1303,南亞         ,20150609,-3,-0.22,52696,3778.3,-1003,-71.92,2430493,174266.35,1651,2646,0.66,0,3,0
1303,南亞         ,20150610,21,1.52,52717,3821.98,-1078,-78.16,2429051,176106.2,1969,2997,0.66,34,13,0
1303,南亞         ,20150611,0,0,52717,3795.62,-2114,-152.21,2426380,174699.36,1826,3915,0.66,0,0,0
1303,南亞         ,20150612,313,22.44,53030,3802.25,-1536,-110.13,2422928,173723.94,1304,3131,0.67,348,35,0
1303,南亞         ,20150615,0,0,53030,3770.43,-1285,-91.36,2417463,171881.62,628,1898,0.67,0,0,0
1303,南亞         ,20150616,150,10.67,53180,3781.1,-196,-13.94,2417250,171866.48,2985,3325,0.67,200,50,0
1303,南亞         ,20150617,-402,-28.14,52778,3694.46,-2706,-189.42,2414710,169029.7,3167,5479,0.67,48,450,0
1303,南亞         ,20150618,-221,-15.36,52557,3652.71,-2000,-139,2412716,167683.76,4206,5979,0.66,350,571,0.01
1303,南亞         ,20150622,-62,-4.48,52495,3790.14,1003,72.42,2412109,174154.27,2615,1744,0.66,62,124,0
1303,南亞         ,20150623,-420,-29.9,52075,3707.74,-2722,-193.81,2404072,171169.93,1166,3539,0.66,60,480,0
1303,南亞         ,20150624,-51,-3.69,52024,3766.54,-896,-64.87,2395535,173436.73,1703,2570,0.66,0,51,0
1303,南亞         ,20150625,-290,-21.17,51734,3776.58,769,56.14,2390598,174513.65,4326,3213,0.65,16,306,0
1303,南亞         ,20150626,7,0.51,51741,3766.74,-1012,-73.67,2382614,173454.3,1649,2703,0.65,9,2,0
1303,南亞         ,20150629,-341,-24.38,51400,3675.1,-1317,-94.17,2378870,170089.21,1122,2118,0.65,0,341,0
1303,南亞         ,20150630,-652,-47.2,86078,6232.05,25,1.81,2414240,174790.98,3915,3251,1.09,0,652,0
1303,南亞         ,20150701,-2,-0.15,86076,6266.33,1573,114.51,2415218,175827.87,4110,2466,1.09,0,2,0
1303,南亞         ,20150702,-554,-39.67,85522,6123.38,-2704,-193.61,2412606,172742.59,1593,3717,1.08,0,554,0
1303,南亞         ,20150703,-500,-35.3,85022,6002.55,-3832,-270.54,2408708,170054.78,2109,5504,1.07,0,500,0
1303,南亞         ,20150706,-343,-24.22,84679,5978.34,-2360,-166.62,2406322,169886.33,2074,3957,1.07,0,343,0
1303,南亞         ,20150707,-500,-35.3,84179,5943.04,-1018,-71.87,2405356,169818.13,2951,3961,1.06,0,500,0
1303,南亞         ,20150708,0,0,84179,5715.75,-5273,-358.04,2400150,162970.19,2370,8559,1.06,0,0,0
1303,南亞         ,20150709,-37,-2.43,84142,5519.72,-5007,-328.46,2395164,157122.76,1834,6159,1.06,2,39,0
1303,南亞         ,20150713,-401,-26.67,83741,5568.78,-1972,-131.14,2394211,159215.03,2389,3900,1.06,0,401,0
1303,南亞         ,20150714,-19,-1.3,83722,5709.84,770,52.51,2395804,163393.83,3450,2381,1.06,0,19,0
1303,南亞         ,20150715,-501,-34.67,83221,5758.89,1371,94.87,2397186,165885.27,5250,3291,1.05,38,539,0
1303,南亞         ,20150716,-574,-39.03,82647,5620,-2332,-158.58,2395047,162863.2,2490,4225,1.04,0,574,0
1303,南亞         ,20150717,-163,-11.12,82484,5625.41,-790,-53.88,2394276,163289.62,2035,2721,1.04,10,173,0
1303,南亞         ,20150720,-13,-0.87,82471,5542.05,-979,-65.79,2393797,160863.16,1448,2343,1.04,0,13,0
1303,南亞         ,20150721,-758,-51.47,81713,5548.31,-73,-4.96,2393891,162545.2,2403,1490,1.03,16,774,0
1303,南亞         ,20150722,-153,-10.21,81560,5440.05,-689,-45.96,2393182,159625.24,2595,3303,1.03,0,153,0
1303,南亞         ,20150723,-232,-15.34,81328,5375.78,653,43.16,2393834,158232.43,2775,2014,1.03,48,280,0
1303,南亞         ,20150724,104,6.92,81432,5415.23,-236,-15.69,2394165,159211.97,1339,1706,1.03,104,0,0
1303,南亞         ,20150727,305,20.1,81737,5386.47,-1462,-96.35,2392917,157693.23,2138,4044,1.03,305,0,0
1303,南亞         ,20150728,360,23.33,82097,5319.89,-2358,-152.8,2391575,154974.06,3477,6582,1.04,360,0,0
1303,南亞         ,20150729,291,18.91,82388,5355.22,863,56.1,2394578,155647.57,3496,2894,1.04,291,0,0
1303,南亞         ,20150730,-21,-1.38,82367,5395.04,84,5.5,2395685,156917.37,2573,2482,1.04,27,48,0
1303,南亞         ,20150731,-568,-36.64,81799,5276.04,-1627,-104.94,2393521,154382.1,3734,4589,1.03,32,600,0
1303,南亞         ,20150803,132,8.45,81931,5243.58,-2993,-191.55,2393193,153164.35,1841,4812,1.03,132,0,0
1303,南亞         ,20150804,-43,-2.83,81888,5388.23,1754,115.41,2395212,157604.95,3246,2377,1.03,79,122,0
1303,南亞         ,20150805,62,4.03,81950,5326.75,-729,-47.39,2394223,155624.5,1374,2465,1.03,62,0,0
1303,南亞         ,20150806,65,4.23,82015,5330.98,-546,-35.49,2392995,155544.68,1152,1851,1.03,73,8,0
1303,南亞         ,20150807,360,23.18,82375,5304.95,-606,-39.03,2392332,154066.18,892,1845,1.04,360,0,0
1303,南亞         ,20150810,16,1.02,82391,5273.02,-288,-18.43,2392840,153141.76,280,560,1.04,22,6,0
1303,南亞         ,20150811,26,1.61,82417,5093.37,-4101,-253.44,2389420,147666.16,2803,6536,1.04,26,0,0
1303,南亞         ,20150812,-393,-24.29,82024,5069.08,742,45.86,2390161,147711.95,3708,2734,1.03,377,770,0.01
1303,南亞         ,20150813,-599,-36.24,81425,4926.21,-3420,-206.91,2385973,144351.37,4366,7028,1.03,374,973,0.01
1303,南亞         ,20150814,-44,-2.68,81381,4947.96,-551,-33.5,2390425,145337.84,3472,3954,1.03,0,44,0
1303,南亞         ,20150817,-11,-0.67,81370,4963.57,-101,-6.16,2392940,145969.34,2406,2525,1.03,3,14,0
1303,南亞         ,20150818,-389,-23.22,80981,4834.57,-1760,-105.07,2390532,142714.76,2887,3908,1.02,1,390,0
1303,南亞         ,20150819,-302,-18.12,80679,4840.74,-2041,-122.46,2388576,143314.56,4828,6521,1.02,2,304,0
1303,南亞         ,20150820,-429,-25.23,80250,4718.7,-3788,-222.73,2385759,140282.63,2777,6096,1.01,2,431,0
1303,南亞         ,20150821,-71,-3.88,80179,4377.77,-162,-8.85,2386314,130292.74,6000,5264,1.01,1,72,0
1303,南亞         ,20150824,-60,-3.19,80119,4254.32,-1705,-90.54,2384671,126626.03,6646,8769,1.01,0,60,0
1303,南亞         ,20150825,-73,-3.94,80046,4338.49,-2990,-162.06,2382226,129116.65,4097,6925,1.01,2,75,0
1303,南亞         ,20150826,92,5.1,80138,4439.65,-3158,-174.95,2378910,131791.61,3771,7020,1.01,92,0,0
1303,南亞         ,20150827,-1,-0.06,80137,4519.73,-2621,-147.82,2376446,134031.55,4815,7278,1.01,1,2,0
1303,南亞         ,20150828,5,0.29,80142,4656.25,-671,-38.99,2375644,138024.92,3350,3794,1.01,5,0,0
1303,南亞         ,20150831,-166,-9.84,79976,4742.58,-696,-41.27,2376246,140911.39,8468,8647,1.01,2,168,0
1303,南亞         ,20150901,-238,-13.57,79738,4545.07,-3217,-183.37,2374091,135323.19,3559,6152,1.01,80,318,0
1303,南亞         ,20150902,-6,-0.34,79732,4520.8,-541,-30.67,2372716,134533,3802,4305,1.01,138,144,0
1303,南亞         ,20150903,62,3.56,79794,4580.18,72,4.13,2370574,136070.95,1856,1778,1.01,62,0,0
1303,南亞         ,20150904,26,1.48,79820,4549.74,-3457,-197.05,2370176,135100.03,779,3955,1.01,27,1,0
1303,南亞         ,20150907,-18,-1.03,79802,4548.71,-1909,-108.81,2368775,135020.18,645,2500,1.01,31,49,0
1303,南亞         ,20150908,17,0.97,79819,4533.72,-2488,-141.32,2366335,134407.83,690,3146,1.01,17,0,0
1303,南亞         ,20150909,1184,69.62,81003,4762.98,3712,218.27,2369982,139354.94,6471,4009,1.02,1184,0,0.01
1303,南亞         ,20150910,-504,-29.13,80499,4652.84,-951,-54.97,2368961,136925.95,3547,4063,1.02,0,504,0
1303,南亞         ,20150911,-291,-17.08,80208,4708.21,-239,-14.03,2368760,139046.21,1304,1214,1.01,17,308,0
1303,南亞         ,20150914,8,0.47,80216,4708.68,-1790,-105.07,2367010,138943.49,1233,2992,1.01,8,0,0
1303,南亞         ,20150915,9,0.53,80225,4693.16,-1049,-61.37,2366216,138423.64,1627,2721,1.01,9,0,0
1303,南亞         ,20150916,-21,-1.24,80204,4724.02,-610,-35.93,2365528,139329.6,3442,4110,1.01,1,22,0
1303,南亞         ,20150917,0,0,80204,4908.48,1625,99.45,2366992,144859.91,5480,4115,1.01,0,0,0
1303,南亞         ,20150918,-417,-25.48,79787,4874.99,-208,-12.71,2367008,144624.19,5180,4746,1.01,0,417,0
1303,南亞         ,20150921,23,1.36,79810,4708.79,-3274,-193.17,2364265,139491.64,1610,4751,1.01,23,0,0
1303,南亞         ,20150922,706,42.24,80516,4814.86,494,29.54,2364785,141414.14,1306,1493,1.02,710,4,0
1303,南亞         ,20150923,0,0,80516,4686.03,-4736,-275.64,2361387,137432.72,833,5589,1.02,0,0,0
1303,南亞         ,20150924,-45,-2.55,80471,4562.71,-5071,-287.53,2356386,133607.09,899,5921,1.01,0,45,0
1303,南亞         ,20150925,770,43.66,81241,4606.36,-554,-31.41,2356697,133624.72,2865,4266,1.02,815,45,0.01
1303,南亞         ,20150930,-40,-2.22,52242,2904.66,-4601,-255.82,2323052,129161.69,5746,10457,0.66,0,40,0
1303,南亞         ,20151001,691,38.9,52933,2980.13,-1419,-79.89,2321066,130676.02,5009,7183,0.67,730,39,0
1303,南亞         ,20151002,601,34.5,53534,3072.85,-1776,-101.94,2318701,133093.44,2850,5239,0.68,601,0,0
1303,南亞         ,20151005,82,4.81,53616,3141.9,1030,60.36,2319741,135936.82,2360,1453,0.68,82,0,0
1303,南亞         ,20151006,315,18.74,53931,3208.89,1311,78,2321208,138111.88,3691,2669,0.68,315,0,0
1303,南亞         ,20151007,1391,85.27,55322,3391.24,3130,191.87,2324490,142491.24,4020,2433,0.7,1391,0,0.01
1303,南亞         ,20151008,120,7.38,55442,3409.68,-469,-28.84,2323888,142919.11,2149,2773,0.7,120,0,0
1303,南亞         ,20151012,39,2.48,55481,3523.04,2179,138.37,2326077,147705.89,6354,4308,0.7,39,0,0
1303,南亞         ,20151013,268,17.21,55749,3579.09,1572,100.92,2327838,149447.2,5061,3623,0.7,268,0,0
1303,南亞         ,20151014,208,13.31,55957,3581.25,561,35.9,2328399,149017.54,5354,4982,0.71,208,0,0
1303,南亞         ,20151015,257,16.78,56214,3670.77,3815,249.12,2332104,152286.39,5860,2365,0.71,257,0,0
1303,南亞         ,20151016,273,17.72,56487,3666.01,591,38.36,2332695,151391.91,2813,2269,0.71,273,0,0
1303,南亞         ,20151019,174,11.47,56661,3733.96,3040,200.34,2336397,153968.56,3498,779,0.71,174,0,0
1303,南亞         ,20151020,352,23.23,57013,3762.86,2754,181.76,2339062,154378.09,4149,1711,0.72,352,0,0
1303,南亞         ,20151021,90,5.99,57103,3803.06,4595,306.03,2344783,156162.55,6339,1665,0.72,90,0,0
1303,南亞         ,20151022,0,0,57103,3734.54,-173,-11.31,2344608,153337.36,2546,2724,0.72,0,0,0
1303,南亞         ,20151023,-91,-6.04,57012,3785.6,5806,385.52,2350947,156102.88,6133,261,0.72,0,91,0
1303,南亞         ,20151026,0,0,57012,3802.7,3998,266.67,2355064,157082.77,4909,1012,0.72,0,0,0
1303,南亞         ,20151027,0,0,57012,3791.3,3246,215.86,2358636,156849.29,4478,1141,0.72,0,0,0
1303,南亞         ,20151028,0,0,57012,3757.09,1111,73.21,2359178,155469.83,2945,1796,0.72,0,0,0
1303,南亞         ,20151029,-261,-16.91,56751,3677.46,755,48.92,2359953,152924.95,3398,2362,0.72,0,261,0
1303,南亞         ,20151030,-1,-0.06,56750,3671.73,2674,173.01,2362258,152838.09,5813,3208,0.72,0,1,0
1303,南亞         ,20151102,0,0,56750,3649.03,-219,-14.08,2362039,151879.11,1879,2136,0.72,0,0,0
1303,南亞         ,20151103,-301,-19.72,56449,3697.41,1649,108.01,2363408,154803.22,4587,2722,0.71,10,311,0
1303,南亞         ,20151104,75,5,56524,3764.5,5627,374.76,2369045,157778.4,9503,4217,0.71,81,6,0
1303,南亞         ,20151105,-75,-4.91,56449,3697.41,-593,-38.84,2368452,155133.61,1634,2074,0.71,0,75,0
1303,南亞         ,20151106,66,4.23,56515,3622.61,-5076,-325.37,2363376,151492.4,2129,7003,0.71,66,0,0
1303,南亞         ,20151109,11,0.7,56526,3578.1,-412,-26.08,2362964,149575.62,1366,1775,0.71,42,31,0
1303,南亞         ,20151110,-74,-4.59,56452,3500.02,-2322,-143.96,2360632,146359.18,2425,4687,0.71,0,74,0
1303,南亞         ,20151111,0,0,56452,3466.15,-1537,-94.37,2358932,144838.42,3107,4596,0.71,0,0,0
1303,南亞         ,20151112,79,4.87,56531,3487.96,-901,-55.59,2358036,145490.82,1324,2299,0.71,79,0,0
1303,南亞         ,20151113,-1,-0.06,56530,3425.72,-2099,-127.2,2355725,142756.94,2215,4261,0.71,0,1,0
1303,南亞         ,20151116,0,0,56530,3391.8,-1187,-71.22,2354567,141274.02,2619,3777,0.71,0,0,0
1303,南亞         ,20151117,0,0,56530,3453.98,184,11.24,2354297,143847.55,2309,2160,0.71,0,0,0
1303,南亞         ,20151118,-239,-14.36,56291,3383.09,-1853,-111.37,2352525,141386.75,2555,4088,0.71,1,240,0
1303,南亞         ,20151119,-141,-8.7,56150,3464.46,409,25.24,2352950,145177.02,3073,2507,0.71,75,216,0
1303,南亞         ,20151120,30,1.83,56180,3432.6,-888,-54.26,2351988,143706.47,1190,2182,0.71,34,4,0
1303,南亞         ,20151123,-2,-0.12,56178,3471.8,-251,-15.51,2351671,145333.27,2025,2324,0.71,0,2,0
1303,南亞         ,20151124,0,0,56178,3381.92,-2807,-168.98,2348901,141403.84,2073,4844,0.71,0,0,0
1303,南亞         ,20151125,0,0,56178,3387.53,-1068,-64.4,2347850,141575.36,1481,2532,0.71,0,0,0
1303,南亞         ,20151126,0,0,56178,3421.24,1665,101.4,2349432,143080.41,3226,1724,0.71,0,0,0
1303,南亞         ,20151127,-144,-8.61,56034,3350.83,-2193,-131.14,2347239,140364.89,1054,3081,0.71,0,144,0
1303,南亞         ,20151130,-440,-25.78,55594,3257.81,-8016,-469.74,2339206,137077.47,11914,19448,0.7,0,440,0
1303,南亞         ,20151201,0,0,55594,3391.23,2365,144.26,2341481,142830.34,5387,3157,0.7,0,0,0
1303,南亞         ,20151202,50,3.05,55644,3394.28,-632,-38.55,2340850,142791.85,3141,3687,0.7,50,0,0
1303,南亞         ,20151203,-45,-2.74,55599,3385.98,125,7.61,2340760,142552.28,2885,2707,0.7,0,45,0
1303,南亞         ,20151204,0,0,55599,3324.82,-5131,-306.83,2335692,139674.38,1270,6338,0.7,0,0,0
1303,南亞         ,20151207,0,0,55599,3380.42,1419,86.28,2337040,142092.03,3401,2100,0.7,0,0,0
1303,南亞         ,20151208,0,0,55599,3280.34,-5665,-334.24,2331538,137560.74,543,5999,0.7,0,0,0
1303,南亞         ,20151209,0,0,55599,3241.42,-3965,-231.16,2327602,135699.2,2785,6721,0.7,0,0,0
1303,南亞         ,20151210,0,0,55599,3235.86,-6502,-378.42,2321519,135112.41,2685,9078,0.7,0,0,0
1303,南亞         ,20151211,0,0,55599,3158.02,-5704,-323.99,2316023,131550.11,3134,8836,0.7,0,0,0
1303,南亞         ,20151214,-253,-14.22,55346,3110.45,-1522,-85.54,2314537,130076.98,1850,3098,0.7,0,253,0
1303,南亞         ,20151215,-463,-26.58,54883,3150.28,-2238,-128.46,2312324,132727.4,2888,4725,0.69,0,463,0
1303,南亞         ,20151216,-834,-47.87,54049,3102.41,-2417,-138.74,2309894,132587.92,3715,5345,0.68,0,834,0.01
1303,南亞         ,20151217,0,0,54049,3156.46,-322,-18.8,2309571,134878.95,2979,3302,0.68,0,0,0
1303,南亞         ,20151218,-127,-7.38,53922,3132.87,-524,-30.44,2309045,134155.51,3708,4116,0.68,0,127,0
1303,南亞         ,20151221,0,0,53922,3138.26,-709,-41.26,2308149,134334.27,1176,1849,0.68,0,0,0
1303,南亞         ,20151222,0,0,53922,3159.83,-330,-19.34,2307014,135191.02,1678,1958,0.68,0,0,0
1303,南亞         ,20151223,0,0,53922,3159.83,457,26.78,2307499,135219.44,1573,1098,0.68,0,0,0
1303,南亞         ,20151224,-1300,-75.4,52622,3052.08,632,36.66,2308062,133867.6,2960,1097,0.66,0,1300,0.01
1303,南亞         ,20151225,0,0,52622,3094.17,986,57.98,2309021,135770.43,1439,480,0.66,0,0,0
1303,南亞         ,20151228,-18,-1.06,52604,3087.85,334,19.61,2309327,135557.49,2095,1771,0.66,0,18,0
1303,南亞         ,20151229,-42,-2.46,52562,3074.88,26,1.52,2308581,135051.99,1345,1278,0.66,0,42,0
1303,南亞         ,20151230,0,0,52562,3101.16,-704,-41.54,2308100,136177.9,1425,1967,0.66,0,0,0
1303,南亞         ,20151231,-2715,-165.62,51774,3158.21,-4636,-282.8,2306722,140710.04,1967,3834,0.65,0,2715,0.02
1303,南亞         ,20160104,0,0,51774,2971.83,-7099,-407.48,2299841,132010.87,455,7507,0.65,0,0,0
1303,南亞         ,20160105,-2472,-142.14,49302,2834.87,-2314,-133.06,2297537,132108.38,2653,2469,0.62,55,2527,0.02
1303,南亞         ,20160106,-127,-7.3,49175,2827.56,-1715,-98.61,2295874,132012.76,2410,3933,0.62,0,127,0
1303,南亞         ,20160107,10,0.58,49185,2833.06,-3016,-173.72,2292249,132033.54,1925,5181,0.62,15,5,0
1303,南亞         ,20160108,15,0.85,49200,2799.48,-3480,-198.01,2288360,130207.68,1729,5213,0.62,15,0,0
1303,南亞         ,20160111,279,15.88,49479,2815.36,-4143,-235.74,2284343,129979.12,1272,5683,0.62,279,0,0
1303,南亞         ,20160112,-55,-3.15,49424,2832,-3706,-212.35,2279908,130638.73,2201,5829,0.62,0,55,0
1303,南亞         ,20160113,-1,-0.06,49423,2822.05,-5221,-298.12,2275076,129906.84,2713,7936,0.62,0,1,0
1303,南亞         ,20160114,-62,-3.52,49361,2798.77,-7682,-435.57,2267414,128562.37,2797,10393,0.62,0,62,0
1303,南亞         ,20160115,-110,-6.24,49251,2792.53,-7925,-449.35,2259994,128141.66,816,8513,0.62,0,110,0
1303,南亞         ,20160118,-1333,-75.45,47918,2712.16,-2923,-165.44,2256345,127709.13,4295,5900,0.6,0,1333,0.01
1303,南亞         ,20160119,-166,-9.35,47752,2688.44,-1415,-79.66,2253389,126865.8,2308,3622,0.6,0,166,0
1303,南亞         ,20160120,-45,-2.52,47707,2666.82,-1706,-95.37,2251707,125870.42,4670,6232,0.6,0,45,0
1303,南亞         ,20160121,0,0,47707,2619.11,-1805,-99.09,2249846,123516.55,2913,4823,0.6,0,0,0
1303,南亞         ,20160122,0,0,47707,2638.2,-15,-0.83,2250205,124436.34,2813,2811,0.6,0,0,0
1303,南亞         ,20160125,-176,-9.93,47531,2680.75,-140,-7.9,2250065,126903.67,2901,2880,0.6,0,176,0
1303,南亞         ,20160126,-15,-0.83,47516,2637.14,-1512,-83.92,2248622,124798.52,1215,2684,0.6,0,15,0
1303,南亞         ,20160127,-246,-13.65,47270,2623.49,-770,-42.74,2247747,124749.96,1606,2142,0.6,0,246,0
1303,南亞         ,20160128,9,0.51,47279,2657.08,1425,80.08,2249123,126400.71,3750,2334,0.6,79,70,0
1303,南亞         ,20160129,-68,-3.93,47211,2728.8,3803,219.81,2253136,130231.26,6859,2862,0.6,2,70,0
1303,南亞         ,20160130,3,0.17,47214,2752.58,839,48.91,2253952,131405.4,813,0,0.6,53,50,0
1303,南亞         ,20160201,-40,-2.36,47174,2783.27,901,53.16,2255200,133056.8,2610,1671,0.59,0,40,0
1303,南亞         ,20160202,-48,-2.85,47126,2799.28,1290,76.63,2256274,134022.68,3321,1994,0.59,0,48,0
1303,南亞         ,20160203,0,0,47126,2771.01,-1516,-89.14,2255019,132595.12,2341,3837,0.59,0,0,0
1303,南亞         ,20160215,0,0,47126,2794.57,281,16.66,2255360,133742.85,4555,4279,0.59,0,0,0
1303,南亞         ,20160216,0,0,47126,2827.56,1948,116.88,2257527,135451.62,10269,8564,0.59,0,0,0
1303,南亞         ,20160217,2,0.12,47128,2841.82,1518,91.54,2258855,136208.96,2153,787,0.59,2,0,0
1303,南亞         ,20160218,0,0,47128,2898.37,3164,194.59,2262018,139114.11,4887,1792,0.59,0,0,0
1303,南亞         ,20160219,63,3.92,47191,2935.28,1698,105.62,2263726,140803.76,2387,784,0.6,63,0,0
1303,南亞         ,20160222,0,0,47191,2921.12,357,22.1,2264089,140147.11,1475,1128,0.6,0,0,0
1303,南亞         ,20160223,0,0,47191,2892.81,-132,-8.09,2264132,138791.29,2215,2300,0.6,0,0,0
1303,南亞         ,20160224,0,0,47191,2944.72,1800,112.32,2265782,141384.8,2797,984,0.6,0,0,0
1303,南亞         ,20160225,0,0,47191,2925.84,-2028,-125.74,2264019,140369.18,3410,5460,0.6,0,0,0
1303,南亞         ,20160226,0,0,47191,3010.79,1431,91.3,2265555,144542.41,6572,5125,0.6,0,0,0
1303,南亞         ,20160301,0,0,47191,3057.98,1797,116.45,2267576,146938.92,4871,3139,0.6,0,0,0
1303,南亞         ,20160302,-38,-2.46,47153,3046.08,709,45.8,2268561,146549.04,1991,1233,0.59,0,38,0
1303,南亞         ,20160303,0,0,47153,3107.38,6217,409.7,2275025,149924.15,7925,1801,0.59,0,0,0
1303,南亞         ,20160304,0,0,47153,3112.1,2988,197.21,2278361,150371.83,4466,1366,0.59,0,0,0
1303,南亞         ,20160307,0,0,47153,3159.25,3428,229.68,2282076,152899.09,4930,1408,0.59,0,0,0
1303,南亞         ,20160308,-22,-1.48,47131,3167.2,2148,144.35,2284388,153510.87,4196,1955,0.59,0,22,0
1303,南亞         ,20160309,-25,-1.66,47106,3132.55,1711,113.78,2286432,152047.73,3300,1557,0.59,5,30,0
1303,南亞         ,20160310,-4,-0.26,47102,3099.31,2160,142.13,2288612,150590.67,4039,1842,0.59,0,4,0
1303,南亞         ,20160311,196,12.9,47298,3112.21,4093,269.32,2293048,150882.56,5067,1159,0.6,200,4,0
1303,南亞         ,20160314,0,0,47298,3102.75,3519,230.85,2296583,150655.84,4290,770,0.6,0,0,0
1303,南亞         ,20160315,1,0.06,47299,3064.98,2507,162.45,2299313,148995.48,3608,1131,0.6,1,0,0
1303,南亞         ,20160316,-1,-0.07,47298,3107.48,4147,272.46,2303560,151343.89,5046,930,0.6,0,1,0
1303,南亞         ,20160317,0,0,47298,3098.02,2718,178.03,2305473,151008.48,5667,2988,0.6,0,0,0
1303,南亞         ,20160318,51,3.42,47349,3177.12,6723,451.11,2312817,155190.02,12305,5681,0.6,51,0,0
1303,南亞         ,20160321,0,0,47349,3186.59,2195,147.72,2315127,155808.05,3976,1714,0.6,0,0,0
1303,南亞         ,20160322,0,0,47349,3172.38,1715,114.91,2317457,155269.62,3935,2120,0.6,0,0,0
1303,南亞         ,20160323,0,0,47349,3167.65,2069,138.42,2319588,155180.44,3024,914,0.6,0,0,0
1303,南亞         ,20160324,75,5.06,47424,3201.12,3417,230.65,2323589,156842.26,4209,922,0.6,75,0,0
1303,南亞         ,20160325,-260,-17.34,47164,3145.84,-277,-18.48,2323401,154970.85,455,407,0.59,0,260,0
1303,南亞         ,20160328,0,0,47164,3159.99,1855,124.29,2325799,155828.53,1953,231,0.59,0,0,0
1303,南亞         ,20160329,-1,-0.07,47163,3136.34,1870,124.36,2327795,154798.37,2626,677,0.59,0,1,0
1303,南亞         ,20160330,-73,-4.93,47090,3183.28,6273,424.05,2334472,157810.31,7396,1094,0.59,0,73,0
1303,南亞         ,20160331,0,0,42531,2875.1,3768,254.72,2333950,157775.02,8540,4739,0.54,0,0,0
1303,南亞         ,20160401,0,0,42531,2845.32,467,31.24,2335130,156220.2,4102,3703,0.54,0,0,0
1303,南亞         ,20160406,0,0,42531,2807.05,258,17.03,2335470,154141.02,5357,5063,0.54,0,0,0
1303,南亞         ,20160407,-54,-3.5,42477,2752.51,-1192,-77.24,2334331,151264.65,5401,6473,0.54,40,94,0
1303,南亞         ,20160408,40,2.62,42517,2789.12,1738,114.01,2336629,153282.86,4806,3107,0.54,40,0,0
1303,南亞         ,20160411,-99,-6.48,42418,2778.38,246,16.11,2336858,153064.2,1728,1385,0.53,0,99,0
1303,南亞         ,20160412,-150,-9.8,42268,2760.1,844,55.11,2337711,152652.53,1958,955,0.53,11,161,0
1303,南亞         ,20160413,-46,-3,42222,2757.1,2730,178.27,2340401,152828.19,4884,2148,0.53,5,51,0
1303,南亞         ,20160414,-145,-9.44,42077,2739.21,2269,147.71,2342703,152509.97,4298,1861,0.53,0,145,0
1303,南亞         ,20160415,-61,-4.04,42016,2785.66,5861,388.58,2347992,155671.87,6216,346,0.53,50,111,0
1303,南亞         ,20160418,80,5.3,42096,2790.96,2631,174.44,2350648,155847.96,3145,543,0.53,80,0,0
1303,南亞         ,20160419,0,0,42096,2778.34,1515,99.99,2352186,155244.28,3215,1677,0.53,0,0,0
1303,南亞         ,20160420,0,0,42096,2715.19,1435,92.56,2353496,151800.49,3847,2648,0.53,0,0,0
1303,南亞         ,20160421,0,0,42096,2694.14,1449,92.74,2354945,150716.48,2291,785,0.53,0,0,0
1303,南亞         ,20160422,-32,-2.08,42064,2734.16,3860,250.9,2358955,153332.08,4829,883,0.53,40,72,0
1303,南亞         ,20160425,-839,-54.12,41225,2659.01,706,45.54,2359671,152198.78,2437,910,0.52,0,839,0.01
1303,南亞         ,20160426,-213,-13.7,41012,2637.07,1789,115.03,2361179,151823.81,3378,1396,0.52,0,213,0
1303,南亞         ,20160427,-770,-50.05,40242,2615.73,2685,174.53,2363864,153651.16,6990,3548,0.51,0,770,0
1303,南亞         ,20160428,0,0,40242,2575.49,-1726,-110.46,2362138,151176.83,3276,4971,0.51,0,0,0
1303,南亞         ,20160429,500,31.6,40742,2574.89,-907,-57.32,2361190,149227.21,2353,3704,0.51,500,0,0
1303,南亞         ,20160503,500,31.35,41242,2585.87,-1477,-92.61,2359713,147954.01,1308,3292,0.52,500,0,0
1303,南亞         ,20160504,203,12.3,41445,2511.57,-3662,-221.92,2356060,142777.24,2205,6097,0.52,203,0,0
1303,南亞         ,20160505,-1304,-78.89,40141,2428.53,-4704,-284.59,2351379,142258.43,2316,5708,0.51,0,1304,0.01
1303,南亞         ,20160506,2,0.12,40143,2416.61,-4162,-250.55,2346952,141286.51,4320,8463,0.51,5,3,0
1303,南亞         ,20160509,350,21.53,40493,2490.32,418,25.71,2347091,144346.1,3966,3914,0.51,350,0,0
1303,南亞         ,20160510,0,0.01,40493,2506.52,-1604,-99.29,2345221,145169.18,3600,5280,0.51,0,0,0
1303,南亞         ,20160511,251,15.49,40744,2513.9,-1026,-63.3,2344556,144659.11,4063,5233,0.51,251,0,0
1303,南亞         ,20160512,0,0,40744,2501.68,-1744,-107.08,2342715,143842.7,625,2373,0.51,0,0,0
1303,南亞         ,20160513,0,0,40744,2424.27,-7320,-435.54,2335412,138957.01,755,8126,0.51,0,0,0
1303,南亞         ,20160516,0,0,40744,2432.42,-2028,-121.07,2333165,139289.95,1561,3582,0.51,0,0,0
1303,南亞         ,20160517,0,0,40744,2420.19,-4324,-256.85,2328595,138318.54,778,5095,0.51,0,0,0
1303,南亞         ,20160518,0,0,40744,2416.12,-2287,-135.62,2326454,137958.72,2831,5121,0.51,0,0,0
1303,南亞         ,20160519,-7,-0.42,40737,2419.78,-4377,-259.99,2322360,137948.18,1677,6034,0.51,0,7,0
1303,南亞         ,20160520,-4,-0.24,40733,2411.39,-3792,-224.49,2326250,137714,1333,5117,0.51,0,4,0
1303,南亞         ,20160523,0,0,40733,2476.57,1048,63.72,2326838,141471.75,3014,1983,0.51,0,0,0
1303,南亞         ,20160524,0,0,40733,2456.2,-1573,-94.85,2324745,140182.12,1025,2619,0.51,0,0,0
1303,南亞         ,20160525,0,0,40733,2488.79,-1015,-62.02,2323741,141980.58,1692,2701,0.51,0,0,0
1303,南亞         ,20160526,1,0.06,40734,2472.55,-1500,-91.05,2322241,140960.03,532,2031,0.51,1,0,0
1303,南亞         ,20160527,-45,-2.74,40689,2473.89,-268,-16.29,2321972,141175.9,1901,2712,0.51,0,45,0
1303,南亞         ,20160530,-25,-1.55,40664,2517.1,2389,147.88,2324362,143878.01,3651,1185,0.51,0,25,0
1303,南亞         ,20160531,-3,-0.19,40661,2529.11,-945,-58.78,2322668,144469.95,10560,11511,0.51,0,3,0
1303,南亞         ,20160601,149,9.24,40810,2530.22,-477,-29.57,2322031,143965.92,4100,4727,0.51,149,0,0
1303,南亞         ,20160602,300,18.51,41110,2536.49,-43,-2.65,2321696,143248.64,3764,4670,0.52,311,11,0
1303,南亞         ,20160603,0,0,41110,2565.26,602,37.56,2321747,144877.01,3439,2807,0.52,0,0,0
1303,南亞         ,20160604,0,0,41110,2569.38,111,6.94,2321566,145097.88,111,0,0.52,0,0,0
1303,南亞         ,20160606,-60,-3.7,41050,2532.79,-1369,-84.47,2320430,143170.53,2051,3306,0.52,0,60,0
1303,南亞         ,20160607,-65,-4.08,40985,2573.86,3259,204.67,2323326,145904.87,4936,1587,0.52,0,65,0
1303,南亞         ,20160608,0,0,40985,2557.46,347,21.65,2323423,144981.6,5000,4643,0.52,0,0,0
1303,南亞         ,20160613,-8,-0.48,40977,2458.62,-2578,-154.68,2320757,139245.42,2507,5071,0.52,0,8,0
1303,南亞         ,20160614,-225,-13.52,40752,2449.2,719,43.21,2321340,139512.53,3209,2609,0.51,0,225,0
1303,南亞         ,20160615,-88,-5.31,40664,2452.04,377,22.73,2321327,139976.02,1705,1726,0.51,0,88,0
1303,南亞         ,20160616,-343,-20.29,40321,2387,-4772,-282.5,2316109,137113.65,1303,6080,0.51,0,343,0
1303,南亞         ,20160617,-260,-15.52,40061,2391.64,1057,63.1,2316664,138304.84,4141,3581,0.51,0,260,0
1303,南亞         ,20160620,-12,-0.72,40049,2418.96,1713,103.47,2318377,140029.97,2747,1212,0.5,0,12,0
1303,南亞         ,20160621,0,0,40049,2430.97,1367,82.98,2322858,140997.48,3053,1683,0.5,0,0,0
1303,南亞         ,20160622,0,0,40049,2434.98,1709,103.91,2325536,141392.59,2739,2159,0.5,0,0,0
1303,南亞         ,20160623,-150,-9.06,39899,2409.9,-151,-9.12,2323985,140368.69,924,925,0.5,0,150,0
1303,南亞         ,20160624,-31,-1.86,39868,2392.08,-1945,-116.7,2322040,139322.4,3446,5900,0.5,6,37,0
1303,南亞         ,20160627,-146,-8.77,39722,2387.29,-1046,-62.86,2320994,139491.74,157,975,0.5,4,150,0
1303,南亞         ,20160628,4,0.24,39726,2383.56,-1050,-63,2319944,139196.64,1712,2767,0.5,4,0,0
1303,南亞         ,20160629,0,0,39726,2423.29,1171,71.43,2321115,141588.02,2139,981,0.5,0,0,0
1303,南亞         ,20160630,0,0,41282,2518.2,461,28.12,2318282,141415.2,5236,4801,0.52,0,0,0
1303,南亞         ,20160701,0,0,41282,2522.33,3971,242.63,2322252,141889.6,4955,1024,0.52,0,0,0
1303,南亞         ,20160704,0,0,41282,2538.84,1135,69.8,2323387,142888.3,1738,565,0.52,0,0,0
1303,南亞         ,20160705,-48,-2.95,41234,2535.89,-433,-26.63,2322954,142861.67,886,1530,0.52,0,48,0
1303,南亞         ,20160706,-51,-3.07,41183,2475.1,-4930,-296.29,2318024,139313.24,1294,6146,0.52,0,51,0
1303,南亞         ,20160707,23,1.4,41206,2509.45,1610,98.05,2319634,141265.71,2672,1238,0.52,23,0,0
1303,南亞         ,20160711,-190,-11.61,41016,2506.08,3048,186.23,2322682,141915.87,5380,2339,0.52,0,190,0
1303,南亞         ,20160712,0,0,41016,2555.3,5027,313.18,2327709,145016.27,6681,1709,0.52,0,0,0
1303,南亞         ,20160713,0,0,41016,2563.5,2173,135.81,2329678,145604.88,3653,1448,0.52,0,0,0
1303,南亞         ,20160714,-3,-0.19,41013,2583.82,3152,198.58,2332873,146971,4571,1588,0.52,0,3,0
1303,南亞         ,20160715,-8,-0.51,41005,2624.32,5154,329.86,2338140,149640.96,7271,2585,0.52,0,8,0
1303,南亞         ,20160718,0,0,41005,2653.02,5681,367.56,2345840,151775.85,4046,3004,0.52,0,0,0
1303,南亞         ,20160719,7,0.44,41012,2563.25,335,20.94,2346332,146645.75,6717,2562,0.52,10,3,0
1303,南亞         ,20160720,33,2.05,41045,2548.89,-302,-18.75,2347340,145769.81,4874,4507,0.52,50,17,0
1303,南亞         ,20160721,-28,-1.74,41017,2555.36,3392,211.32,2351930,146525.24,6001,2676,0.52,2,30,0
1303,南亞         ,20160722,60,3.73,41077,2550.88,437,27.14,2356191,146319.46,5616,5242,0.52,83,23,0
1303,南亞         ,20160725,236,14.66,41313,2565.54,2680,166.43,2360155,146565.63,4515,1944,0.52,236,0,0
1303,南亞         ,20160726,-2,-0.12,41311,2561.28,1041,64.54,2365736,146675.63,3012,1906,0.52,78,80,0
1303,南亞         ,20160727,-125,-7.7,41186,2537.06,-636,-39.18,2365100,145690.16,2063,2480,0.52,0,125,0
1303,南亞         ,20160728,-134,-8.21,41052,2516.49,873,53.51,2365973,145034.14,3758,2721,0.52,0,134,0
1303,南亞         ,20160729,-53,-3.2,40999,2476.34,-1831,-110.59,2361949,142661.72,1607,3357,0.52,1,54,0
1303,南亞         ,20160801,0,0,40999,2525.54,1173,72.26,2362308,145518.17,4052,2704,0.52,0,0,0
1303,南亞         ,20160802,-5,-0.31,40994,2529.33,-436,-26.9,2361159,145683.51,1611,1781,0.52,0,5,0
1303,南亞         ,20160803,17,1.03,41011,2481.17,-2758,-166.86,2358521,142690.52,1092,3766,0.52,28,11,0
1303,南亞         ,20160804,30,1.82,41041,2495.29,-1440,-87.55,2357344,143326.52,2218,3439,0.52,32,2,0
1303,南亞         ,20160805,-6,-0.37,41035,2527.76,2141,131.89,2359527,145346.86,3848,1659,0.52,0,6,0
1303,南亞         ,20160808,-37,-2.29,40998,2533.68,404,24.97,2359969,145846.08,2036,1556,0.52,1,38,0
1303,南亞         ,20160809,-1,-0.06,40997,2533.61,605,37.39,2360536,145881.12,2764,2199,0.52,0,1,0
1303,南亞         ,20160810,0,0,40997,2558.21,2308,144.02,2362811,147439.41,4376,2101,0.52,0,0,0
1303,南亞         ,20160811,0,0,40997,2562.31,1178,73.63,2364110,147756.88,2790,1492,0.52,3,3,0
1303,南亞         ,20160812,-8,-0.5,40989,2565.91,1969,123.26,2366106,148118.24,3448,1471,0.52,0,8,0
1303,南亞         ,20160815,-13,-0.82,40976,2573.29,1964,123.34,2368095,148716.37,2800,814,0.52,0,13,0
1303,南亞         ,20160816,3,0.19,40979,2540.7,-399,-24.74,2367751,146800.56,2817,3161,0.52,15,12,0
1303,南亞         ,20160817,3,0.19,40982,2532.69,680,42.02,2368659,146383.13,2319,1414,0.52,3,0,0
1303,南亞         ,20160818,-4,-0.25,40978,2524.24,303,18.66,2369025,145931.94,1536,1166,0.52,0,4,0
1303,南亞         ,20160819,-159,-9.67,40819,2481.8,-627,-38.12,2368395,143998.42,2142,2613,0.51,8,167,0
1303,南亞         ,20160822,9,0.55,40828,2482.34,-813,-49.43,2367645,143952.82,1321,2066,0.51,9,0,0
1303,南亞         ,20160823,-9,-0.55,40819,2494.04,593,36.23,2368226,144698.61,1398,808,0.51,0,9,0
1303,南亞         ,20160824,-9,-0.55,40810,2481.25,-2,-0.12,2368229,143988.32,1070,1068,0.51,0,9,0
1303,南亞         ,20160825,10,0.62,40820,2518.59,1427,88.05,2369649,146207.34,2579,1204,0.51,12,2,0
1303,南亞         ,20160826,1,0.06,40821,2526.82,1044,64.62,2370671,146744.53,1542,534,0.51,1,0,0
1303,南亞         ,20160829,-4,-0.25,40817,2514.33,-575,-35.42,2370151,146001.3,1317,1861,0.51,0,4,0
1303,南亞         ,20160830,37,2.27,40854,2508.44,246,15.1,2370463,145546.43,1636,1422,0.52,39,2,0
1303,南亞         ,20160831,42,2.55,40896,2478.3,-1948,-118.05,2367886,143493.89,4032,5961,0.52,42,0,0
1303,南亞         ,20160901,119,7.15,41015,2465,-4127,-248.03,2363859,142067.93,898,5073,0.52,119,0,0
1303,南亞         ,20160902,6,0.36,41021,2473.57,8,0.48,2363969,142547.33,1387,1377,0.52,6,0,0
1303,南亞         ,20160905,-12,-0.73,41009,2509.75,1240,75.89,2365557,144772.09,1699,395,0.52,1,13,0
1303,南亞         ,20160906,85,5.25,41094,2539.61,3131,193.5,2368892,146397.53,4120,1084,0.52,85,0,0
1303,南亞         ,20160907,12,0.75,41106,2565.01,772,48.17,2370098,147894.12,1934,1169,0.52,12,0,0
1303,南亞         ,20160908,6,0.37,41112,2553.06,-1217,-75.58,2369347,147136.45,1187,2410,0.52,15,9,0
1303,南亞         ,20160909,4,0.24,41116,2503.96,-3003,-182.88,2366391,144113.21,996,3968,0.52,4,0,0
1303,南亞         ,20160910,0,0,41116,2503.96,-1034,-62.97,2365542,144061.51,0,849,0.52,0,0,0
1303,南亞         ,20160912,0,0,41116,2475.18,-6136,-369.39,2359593,142047.5,349,6477,0.52,0,0,0
1303,南亞         ,20160913,-3,-0.18,41113,2466.78,-4921,-295.26,2354922,141295.32,2875,7774,0.52,1,4,0
1303,南亞         ,20160914,75,4.46,41188,2446.57,-5849,-347.43,2349202,139542.6,3203,9104,0.52,75,0,0
1303,南亞         ,20160919,0,0,41188,2495.99,-4685,-283.91,2344453,142073.85,1956,6738,0.52,0,0,0
1303,南亞         ,20160920,0,0,41188,2500.11,-2843,-172.57,2341237,142113.09,1091,3955,0.52,0,0,0
1303,南亞         ,20160921,0,0,41188,2512.47,-807,-49.23,2340551,142773.61,2727,3414,0.52,0,0,0
1303,南亞         ,20160922,-2,-0.12,41186,2528.82,677,41.57,2341231,143751.58,1708,1005,0.52,0,2,0
1303,南亞         ,20160923,-19,-1.18,41167,2560.59,723,44.97,2341878,145664.81,3320,2682,0.52,0,19,0
1303,南亞         ,20160926,15,0.93,41182,2561.52,-264,-16.42,2341550,145644.41,815,1154,0.52,15,0,0
1303,南亞         ,20160929,0,0,41182,2573.88,2828,176.75,2344428,146526.75,6429,3626,0.52,0,0,0
1303,南亞         ,20160930,74,4.59,25750,1596.5,-3965,-245.83,2327781,144322.42,1898,5912,0.32,74,0,0
1303,南亞         ,20161003,51,3.14,25801,1586.76,-1146,-70.48,2327255,143126.18,1071,2246,0.33,51,0,0
1303,南亞         ,20161004,0,0,25801,1615.14,1666,104.29,2328995,145795.09,2898,1227,0.33,0,0,0
1303,南亞         ,20161005,0,0,25801,1609.98,-386,-24.09,2328291,145285.36,448,820,0.33,0,0,0
1303,南亞         ,20161006,0,0,25801,1615.14,220,13.77,2328542,145766.73,1440,1189,0.33,0,0,0
1303,南亞         ,20161007,1,0.06,25802,1625.53,85,5.36,2328629,146703.63,1603,1527,0.33,1,0,0
1303,南亞         ,20161011,-138,-8.72,25664,1616.83,-1849,-116.49,2326809,146588.97,2771,4495,0.32,8,146,0
1303,南亞         ,20161012,-80,-5.06,25584,1616.91,-285,-18.01,2326403,147028.67,2755,3008,0.32,0,80,0
1303,南亞         ,20161013,0,0,25584,1614.35,-3656,-230.69,2322754,146565.78,2533,6182,0.32,0,0,0
1303,南亞         ,20161014,61,3.85,25645,1618.2,-183,-11.55,2322609,146556.63,1845,2105,0.32,61,0,0
1303,南亞         ,20161017,0,0,25645,1610.51,-763,-47.92,2321867,145813.25,2620,3356,0.32,0,0,0
1303,南亞         ,20161018,0,0,25645,1631.02,2237,142.27,2324292,147824.97,2999,751,0.32,0,0,0
1303,南亞         ,20161019,1056,67.48,26701,1706.19,-84,-5.37,2324510,148536.19,2929,3328,0.34,1156,100,0.01
1303,南亞         ,20161020,192,12.48,26893,1748.05,-121,-7.87,2325946,151186.49,3244,2614,0.34,282,90,0
1303,南亞         ,20161021,47,3.04,26940,1740.32,1243,80.3,2329018,150454.56,11655,9834,0.34,47,0,0
1303,南亞         ,20161024,0,0,26940,1737.63,-1361,-87.78,2327698,150136.52,1297,2637,0.34,0,0,0
1303,南亞         ,20161025,-17,-1.1,26923,1747.3,692,44.91,2328191,151099.6,2007,1262,0.34,0,17,0
1303,南亞         ,20161026,-132,-8.62,26791,1749.45,981,64.06,2330206,152162.45,3507,2444,0.34,0,132,0
1303,南亞         ,20161027,0,0,26791,1749.45,-202,-13.19,2329985,152148.02,3229,3165,0.34,0,0,0
1303,南亞         ,20161028,0,0,26791,1754.81,1414,92.62,2331240,152696.22,3736,2308,0.34,0,0,0
1303,南亞         ,20161031,-5,-0.35,26786,1759.84,-596,-39.16,2330526,153115.56,2866,3459,0.34,0,5,0
1303,南亞         ,20161101,-2,-0.13,26784,1738.28,-907,-58.86,2329507,151185,712,1635,0.34,0,2,0
1303,南亞         ,20161102,0,-0.02,26784,1727.57,-544,-35.09,2328974,150218.82,1025,1584,0.34,0,0,0
1303,南亞         ,20161103,0,0,26784,1714.18,-778,-49.79,2328196,149004.54,1646,2485,0.34,0,0,0
1303,南亞         ,20161104,-115,-7.42,26669,1720.15,28,1.81,2328224,150170.45,1975,1819,0.34,0,115,0
1303,南亞         ,20161107,-2,-0.13,26667,1728.02,-676,-43.8,2327558,150825.76,856,1646,0.34,0,2,0
1303,南亞         ,20161108,-254,-16.64,26413,1730.05,1203,78.8,2328742,152532.6,2633,1218,0.33,146,400,0
1303,南亞         ,20161109,-300,-19.32,26113,1681.68,-2324,-149.67,2326496,149826.34,3727,5433,0.33,0,300,0
1303,南亞         ,20161110,373,24.62,26486,1748.08,1934,127.64,2328362,153671.89,3279,1836,0.33,373,0,0
1303,南亞         ,20161111,0,0,26486,1713.64,-6283,-406.51,2322088,150239.09,1210,7657,0.33,0,0,0
1303,南亞         ,20161114,-79,-5.06,26407,1690.05,-4540,-290.56,2317832,148341.25,1751,6182,0.33,0,79,0
1303,南亞         ,20161115,86,5.55,26493,1708.8,-1811,-116.81,2316527,149415.99,1420,3328,0.33,86,0,0
1303,南亞         ,20161116,-60,-3.91,26433,1723.43,-1930,-125.84,2314147,150882.38,940,2601,0.33,0,60,0
1303,南亞         ,20161117,160,10.54,26593,1752.48,-874,-57.6,2312692,152406.4,1597,2478,0.34,177,17,0
1303,南亞         ,20161118,101,6.61,26694,1745.79,-3059,-200.06,2309584,151046.79,953,4224,0.34,101,0,0
1303,南亞         ,20161121,100,6.51,26794,1744.29,-970,-63.15,2308405,150277.17,496,1530,0.34,100,0,0
1303,南亞         ,20161122,124,8.2,26918,1779.28,2468,163.13,2310771,152741.96,3029,1061,0.34,144,20,0
1303,南亞         ,20161123,22,1.46,26940,1791.51,1410,93.77,2312181,153760.04,1749,365,0.34,22,0,0
1303,南亞         ,20161124,81,5.39,27021,1796.9,903,60.05,2313091,153820.55,1539,726,0.34,87,6,0
1303,南亞         ,20161125,216,14.32,27237,1805.81,785,52.05,2313919,153412.83,991,434,0.34,216,0,0
1303,南亞         ,20161128,8,0.54,27245,1825.42,2085,139.69,2316098,155178.57,2309,309,0.34,8,0,0
1303,南亞         ,20161129,-21,-1.4,27224,1815.84,727,48.49,2317647,154587.05,2857,2204,0.34,41,62,0
1303,南亞         ,20161130,376,25.23,27600,1851.96,2394,160.64,2319976,155670.39,7191,5152,0.35,376,0,0
1303,南亞         ,20161201,1292,88.5,28892,1979.1,4863,333.12,2325007,159262.98,5256,3003,0.36,1294,2,0.01
1303,南亞         ,20161202,1013,69.69,29905,2057.46,264,18.16,2325333,159982.91,2207,2884,0.38,1013,0,0.01
1303,南亞         ,20161205,1512,102.97,31417,2139.5,1465,99.77,2325245,158349.18,2460,2481,0.4,1512,0,0.01
1303,南亞         ,20161206,1500,103.65,32917,2274.56,3462,239.22,2328706,160913.58,3560,1733,0.42,1500,0,0.01
1303,南亞         ,20161207,339,23.42,33256,2297.99,156,10.78,2328958,160931,945,1420,0.42,346,7,0
1303,南亞         ,20161208,2099,148.19,35355,2496.06,8489,599.32,2337475,165025.73,6369,1058,0.45,2099,0,0.01
1303,南亞         ,20161209,28,2.01,35383,2536.96,2106,151,2339781,167762.3,3423,1664,0.45,28,0,0
1303,南亞         ,20161212,839,60.83,36222,2626.1,1471,106.65,2341479,169757.23,1816,2119,0.46,839,0,0.01
1303,南亞         ,20161213,89,6.44,36311,2628.92,973,70.45,2343274,169653.04,2789,1669,0.46,99,10,0
1303,南亞         ,20161214,274,19.67,36585,2626.8,1273,91.4,2344299,168320.67,2418,1263,0.46,274,0,0
1303,南亞         ,20161215,20,1.4,36605,2558.69,-1901,-132.88,2342408,163734.32,6335,7798,0.46,20,0,0
1303,南亞         ,20161216,201,14.45,36806,2646.35,1838,132.15,2344285,168554.09,7313,5377,0.46,201,0,0
1303,南亞         ,20161219,60,4.35,36866,2672.79,3674,266.37,2347970,170227.83,4409,1037,0.46,60,0,0
1303,南亞         ,20161220,-95,-6.89,36771,2665.9,895,64.89,2349311,170325.05,2188,1197,0.46,0,95,0
1303,南亞         ,20161221,104,7.56,36875,2680.81,2321,168.74,2351642,170964.37,3170,1083,0.46,104,0,0
1303,南亞         ,20161222,608,43.29,37483,2668.79,195,13.88,2351847,167451.51,2328,2545,0.47,611,3,0
1303,南亞         ,20161223,0,0,37483,2638.8,2969,209.02,2354816,165779.05,5365,1967,0.47,0,0,0
1303,南亞         ,20161226,0,0,37483,2646.3,650,45.89,2355482,166297.03,1089,222,0.47,0,0,0
1303,南亞         ,20161227,0,0,37483,2627.56,215,15.07,2355308,165107.09,839,325,0.47,0,0,0
1303,南亞         ,20161228,141,10.01,37624,2671.3,1652,117.29,2356982,167345.72,2607,584,0.47,141,0,0
1303,南亞         ,20161229,468,33.23,38092,2704.53,2262,160.6,2358391,167445.76,3943,2638,0.48,482,14,0
1303,南亞         ,20161230,0,0,33497,2384.99,2009,143.04,2355928,167742.07,3245,1205,0.42,0,0,0
1303,南亞         ,20170103,0,0,33497,2384.99,657,46.78,2356595,167789.56,1875,1388,0.42,0,0,0
1303,南亞         ,20170104,0,0,33497,2401.73,2088,149.71,2358682,169117.5,4361,1857,0.42,0,0,0
1303,南亞         ,20170105,289,21.21,33786,2479.89,5809,426.38,2364502,173554.45,5923,1405,0.43,291,2,0
1303,南亞         ,20170106,1424,104.52,35210,2584.41,2990,219.47,2367544,173777.73,1923,1341,0.44,1435,11,0.01
1303,南亞         ,20170109,703,51.88,35913,2650.38,1882,138.89,2369505,174869.47,2477,1530,0.45,703,0,0
1303,南亞         ,20170110,1792,131,37705,2756.24,2545,186.04,2372060,173397.59,2239,1445,0.48,1792,0,0.01
1303,南亞         ,20170111,-37,-2.68,37668,2727.16,635,45.97,2372695,171783.12,2794,1947,0.47,0,37,0
1303,南亞         ,20170112,415,30.46,38083,2795.29,6186,454.05,2378880,174609.79,7121,962,0.48,441,26,0
1303,南亞         ,20170113,750,55.05,38833,2850.34,1756,128.89,2380346,174717.4,3975,1817,0.49,750,0,0
1303,南亞         ,20170116,256,18.61,39089,2841.77,-145,-10.54,2380201,173040.61,912,1106,0.49,256,0,0
1303,南亞         ,20170117,12,0.88,39101,2854.37,1432,104.54,2381643,173859.94,2010,304,0.49,25,13,0
1303,南亞         ,20170118,1727,127.11,40828,3004.94,2833,208.51,2384617,175507.81,5059,3107,0.51,1753,26,0.01
1303,南亞         ,20170119,1043,75.51,41871,3031.46,302,21.86,2384953,172670.6,2428,2920,0.53,1070,27,0.01
1303,南亞         ,20170120,2022,146.39,43893,3177.85,989,71.6,2385922,172740.75,1996,3028,0.55,2022,0,0.01
1303,南亞         ,20170123,1273,93.59,45166,3319.7,4433,325.83,2390355,175691.09,5541,2266,0.57,1274,1,0.01
1303,南亞         ,20170124,239,17.57,45405,3337.27,1984,145.82,2391643,175785.76,3749,1992,0.57,239,0,0
1303,南亞         ,20170202,167,12.42,45572,3390.56,2461,183.1,2394756,178169.85,12125,9904,0.57,327,160,0
1303,南亞         ,20170203,376,28.01,45948,3423.13,980,73.01,2395781,178485.68,4193,3512,0.58,376,0,0
1303,南亞         ,20170206,1024,76.19,46972,3494.72,1512,112.49,2397298,178358.97,2387,1977,0.59,1058,34,0.01
1303,南亞         ,20170207,309,23.21,47281,3550.8,2495,187.37,2400021,180241.58,2594,1001,0.6,460,151,0
1303,南亞         ,20170208,2373,178.45,49654,3733.98,1703,128.07,2401723,180609.57,3144,3957,0.63,2573,200,0.02
1303,南亞         ,20170209,102,7.68,49756,3746.63,2397,180.49,2404132,181031.14,3085,784,0.63,102,0,0
1303,南亞         ,20170210,1213,93.64,50969,3934.81,6707,517.78,2410891,186120.79,5101,1147,0.64,1219,6,0.01
1303,南亞         ,20170213,700,54.67,51669,4035.35,2826,220.71,2413485,188493.18,2654,1057,0.65,732,32,0
1303,南亞         ,20170214,621,48.31,52290,4068.16,421,32.75,2413917,187802.74,3151,3497,0.66,621,0,0
1303,南亞         ,20170215,13,1.03,52303,4131.94,2339,184.78,2416256,190884.22,5483,3942,0.66,49,36,0
1303,南亞         ,20170216,0,0,52303,4048.25,1549,119.89,2417815,187138.88,2987,1527,0.66,0,0,0
1303,南亞         ,20170217,-381,-29.34,51922,3997.99,-609,-46.89,2417206,186124.86,3477,3727,0.65,62,443,0
1303,南亞         ,20170218,-53,-4.07,51869,3978.35,-158,-12.12,2417048,185387.58,54,200,0.65,100,153,0
1303,南亞         ,20170220,-341,-25.68,51528,3880.06,-2091,-157.45,2414993,181848.97,2537,2874,0.65,5,346,0
1303,南亞         ,20170221,-1026,-76.64,50502,3772.5,1813,135.43,2416816,180536.16,7272,2740,0.64,181,1207,0.01
1303,南亞         ,20170222,226,16.79,50728,3769.09,990,73.56,2417517,179621.51,2585,1894,0.64,263,37,0
1303,南亞         ,20170223,2,0.15,50730,3789.53,413,30.85,2417940,180620.12,4284,4038,0.64,2,0,0
1303,南亞         ,20170224,0,0,50730,3784.46,-333,-24.84,2415790,180217.93,1707,2779,0.64,0,0,0
1303,南亞         ,20170301,-247,-17.91,50483,3660.02,-3788,-274.63,2412487,174905.31,2671,5727,0.64,61,308,0
1303,南亞         ,20170302,-1054,-75.89,49429,3558.89,-31,-2.23,2413499,173771.93,7161,6095,0.62,157,1211,0.01
1303,南亞         ,20170303,-253,-17.94,49176,3486.58,-1122,-79.55,2413166,171093.47,4578,5558,0.62,103,356,0
1303,南亞         ,20170306,110,7.82,49286,3504.23,1320,93.85,2414445,171667.04,4426,3264,0.62,199,89,0
1303,南亞         ,20170307,46,3.33,49332,3571.64,1126,81.52,2415437,174877.64,1951,1004,0.62,46,0,0
1303,南亞         ,20170308,-723,-51.91,48609,3490.13,-2584,-185.53,2413012,173254.26,1080,2782,0.61,329,1052,0.01
1303,南亞         ,20170309,-73,-5.12,48536,3407.23,-6187,-434.33,2408064,169046.09,2913,7789,0.61,50,123,0
1303,南亞         ,20170310,-364,-25.33,48172,3352.77,51,3.55,2408124,167605.43,2743,2319,0.61,250,614,0.01
1303,南亞         ,20170313,163,11.34,48335,3364.12,-709,-49.35,2407432,167557.27,1413,2268,0.61,163,0,0
1303,南亞         ,20170314,63,4.39,48398,3373.34,141,9.83,2407491,167802.12,3837,3851,0.61,137,74,0
1303,南亞         ,20170315,-2,-0.14,48396,3382.88,-296,-20.69,2407044,168252.38,2287,2693,0.61,100,102,0
1303,南亞         ,20170316,1359,97.71,49755,3577.38,4927,354.25,2411839,173411.22,4663,1364,0.63,1359,0,0.01
1303,南亞         ,20170317,220,15.73,49975,3573.21,-1907,-136.35,2410419,172344.96,7890,9983,0.63,248,28,0
1303,南亞         ,20170320,3,0.22,49978,3588.42,156,11.2,2410598,173080.94,2201,2039,0.63,14,11,0
1303,南亞         ,20170321,-2161,-155.59,47817,3442.82,964,69.41,2411593,173634.7,4244,1124,0.6,110,2271,0.02
1303,南亞         ,20170322,-315,-22.55,47502,3401.14,-322,-23.06,2411361,172653.45,2167,2150,0.6,86,401,0
1303,南亞         ,20170323,-45,-3.21,47457,3388.43,565,40.34,2412005,172217.16,1220,582,0.6,0,45,0
1303,南亞         ,20170324,-182,-13.01,47275,3380.16,268,19.16,2410255,172333.23,1725,1275,0.6,17,199,0
1303,南亞         ,20170327,80,5.78,47355,3423.77,556,40.2,2410885,174306.99,2744,2220,0.6,80,0,0
1303,南亞         ,20170328,-51,-3.7,47304,3434.27,2266,164.51,2413253,175202.17,5486,3166,0.6,50,101,0
1303,南亞         ,20170329,341,24.75,47645,3459.03,-525,-38.12,2412633,175157.16,2266,3355,0.6,384,43,0
1303,南亞         ,20170330,-210,-15.2,47435,3439.04,-928,-67.28,2411774,174853.62,2216,2924,0.6,26,236,0
1303,南亞         ,20170331,-225,-16.17,47127,3388.43,-1745,-125.47,2409972,173276.99,2892,4412,0.59,34,259,0
1303,南亞         ,20170405,-471,-33.91,46656,3359.23,-2404,-173.09,2408177,173388.74,6394,8362,0.59,192,663,0.01
1303,南亞         ,20170406,-66,-4.74,46590,3345.16,-1139,-81.78,2407038,172825.33,3128,4199,0.59,97,163,0
1303,南亞         ,20170407,-365,-26.1,46225,3305.09,-2452,-175.32,2405113,171965.58,2985,4512,0.58,124,489,0
1303,南亞         ,20170410,52,3.73,46277,3318.06,-773,-55.42,2404374,172393.62,2557,2948,0.58,52,0,0
1303,南亞         ,20170411,91,6.55,46368,3338.5,614,44.21,2404956,173156.83,2789,2298,0.58,91,0,0
1303,南亞         ,20170412,-113,-8.08,46255,3307.23,218,15.59,2405157,171968.73,1790,1440,0.58,150,263,0
1303,南亞         ,20170413,183,13.25,46438,3362.11,1109,80.29,2406213,174209.82,1942,1082,0.59,183,0,0
1303,南亞         ,20170414,80,5.76,46518,3349.3,-860,-61.92,2405482,173194.7,529,1373,0.59,100,20,0
1303,南亞         ,20170417,0,0,46518,3358.6,-1088,-78.55,2404191,173582.59,417,1504,0.59,0,0,0
1303,南亞         ,20170418,2,0.14,46520,3358.74,-1529,-110.39,2402767,173479.78,621,2118,0.59,2,0,0
1303,南亞         ,20170419,-605,-43.01,45915,3264.56,-4396,-312.56,2398477,170531.71,1106,4819,0.58,8,613,0
1303,南亞         ,20170420,-1895,-134.92,44020,3134.22,-3853,-274.33,2394386,170480.28,1796,3705,0.56,2,1897,0.01
1303,南亞         ,20170421,0,0,44020,3147.43,-567,-40.54,2393760,171153.84,891,1518,0.56,0,0,0
1303,南亞         ,20170424,-561,-40.11,43459,3107.32,-669,-47.83,2393109,171107.29,7600,7690,0.55,0,561,0
1303,南亞         ,20170425,-2812,-202.48,40647,2926.58,-68,-4.9,2392752,172278.14,3750,1055,0.51,0,2812,0.02
1303,南亞         ,20170426,-532,-38.89,40115,2932.41,5564,406.73,2397912,175287.37,7319,1627,0.51,3,535,0
1303,南亞         ,20170427,100,7.25,40215,2915.59,-1708,-123.83,2396161,173721.67,1295,3031,0.51,101,1,0
1303,南亞         ,20170428,-55,-4,40160,2919.63,-1869,-135.88,2394249,174061.9,2078,3935,0.51,0,55,0
1303,南亞         ,20170502,348,25.33,40508,2948.98,1373,99.95,2395622,174401.28,15216,14429,0.51,348,0,0
1303,南亞         ,20170503,0,0,40508,2948.98,-143,-10.41,2395282,174376.53,1277,1418,0.51,0,0,0
1303,南亞         ,20170504,17,1.26,40525,2929.96,-998,-72.16,2394284,173106.73,2223,3225,0.51,42,25,0
1303,南亞         ,20170505,-3028,-214.97,37497,2662.29,-5318,-377.58,2389097,169625.89,2165,4101,0.47,0,3028,0.02
1303,南亞         ,20170508,0,0,37497,2662.29,-724,-51.4,2388382,169575.12,1754,2468,0.47,0,0,0
1303,南亞         ,20170509,-152,-10.7,37345,2629.09,-512,-36.04,2387906,168108.58,2281,2596,0.47,0,152,0
1303,南亞         ,20170510,-716,-50.19,36629,2567.69,-1205,-84.47,2386706,167308.09,2449,2932,0.46,0,716,0
1303,南亞         ,20170511,-1780,-125.31,34849,2453.37,-3218,-226.55,2382985,167762.14,2762,4219,0.44,0,1780,0.01
1303,南亞         ,20170512,-1108,-77.78,33741,2368.62,-1390,-97.58,2381691,167194.71,1845,2100,0.43,0,1108,0.01
1303,南亞         ,20170515,231,16.33,33972,2401.82,507,35.84,2382205,168421.89,4189,3905,0.43,311,80,0
1303,南亞         ,20170516,791,56.16,34763,2468.17,1378,97.84,2383374,169219.55,4685,6143,0.44,914,123,0.01
1303,南亞         ,20170517,-220,-15.64,34543,2456.01,1287,91.51,2384610,169545.77,3207,3173,0.44,0,220,0
1303,南亞         ,20170518,-339,-24.2,34204,2442.17,2378,169.79,2386988,170430.94,1124,883,0.43,0,339,0
1303,南亞         ,20170519,-691,-48.85,33513,2369.37,-786,-55.57,2386273,168709.5,507,2576,0.42,0,691,0
1303,南亞         ,20170522,-229,-16.35,33284,2376.48,1465,104.6,2387738,170484.49,1877,1987,0.42,0,229,0
1303,南亞         ,20170523,-119,-8.43,33165,2348.08,314,22.23,2388062,169074.79,1302,1855,0.42,0,119,0
1303,南亞         ,20170524,-236,-16.73,32929,2334.67,1740,123.37,2389802,169436.96,1783,823,0.42,0,236,0
1303,南亞         ,20170525,-156,-11.14,32773,2339.99,2302,164.36,2392105,170796.3,2128,1472,0.41,0,156,0
1303,南亞         ,20170526,-266,-18.99,32507,2321,1659,118.45,2393764,170914.75,3441,2489,0.41,0,266,0
1303,南亞         ,20170531,-40,-2.86,32467,2324.64,3555,254.54,2379741,170389.46,15222,14864,0.41,0,40,0
1303,南亞         ,20170601,-190,-13.59,32277,2307.81,1309,93.59,2380969,170239.28,2094,2866,0.41,0,190,0
1303,南亞         ,20170602,-56,-3.99,32221,2297.36,492,35.08,2381461,169798.17,2006,2857,0.41,0,56,0
1303,南亞         ,20170603,-431,-30.6,31790,2257.09,-363,-25.77,2381098,169057.96,0,20,0.4,0,431,0
1303,南亞         ,20170605,-333,-23.81,31457,2249.18,3138,224.37,2384236,170472.87,2564,1288,0.4,31,364,0
1303,南亞         ,20170606,8,0.57,31465,2256.04,1509,108.2,2385693,171054.19,1920,2651,0.4,42,34,0
1303,南亞         ,20170607,-31,-2.23,31434,2260.1,1666,119.79,2387359,171651.11,3158,2974,0.4,0,31,0
1303,南亞         ,20170608,209,15.05,31643,2278.3,1190,85.68,2388550,171975.6,1332,2021,0.4,212,3,0
1303,南亞         ,20170609,-111,-7.99,31532,2270.3,-24,-1.73,2388525,171973.8,7340,8888,0.4,0,111,0
1303,南亞         ,20170612,-127,-9.06,31405,2239.18,-2586,-184.38,2385634,170095.7,461,4131,0.4,0,127,0
1303,南亞         ,20170613,-160,-11.55,31245,2255.89,-227,-16.39,2384035,172127.33,1030,1041,0.39,0,160,0
1303,南亞         ,20170614,-148,-10.7,31097,2248.31,833,60.23,2383163,172302.68,2062,1338,0.39,0,148,0
1303,南亞         ,20170615,0,0,31097,2248.31,-964,-69.7,2380203,172088.68,1457,2181,0.39,0,0,0
1303,南亞         ,20170616,-591,-42.55,30506,2196.43,-3329,-239.69,2375280,171020.16,3267,6030,0.38,0,591,0
1303,南亞         ,20170619,-164,-11.86,30342,2193.73,-422,-30.51,2374857,171702.16,1166,1441,0.38,8,172,0
1303,南亞         ,20170620,-31,-2.24,30311,2188.45,-394,-28.45,2374215,171418.32,832,1228,0.38,0,31,0
1303,南亞         ,20170621,-100,-7.25,30211,2190.3,769,55.75,2374706,172166.19,4129,3892,0.38,0,100,0
1303,南亞         ,20170622,0,0,30211,2190.3,3227,233.96,2383454,172800.42,3103,1372,0.38,0,0,0
1303,南亞         ,20170623,-9,-0.66,30202,2198.71,3686,268.34,2386044,173704,3203,1138,0.38,0,9,0
1303,南亞         ,20170626,163,12.23,30365,2277.38,9547,716.03,2394219,179566.43,7694,377,0.38,330,167,0
1303,南亞         ,20170627,201,15.03,30566,2286.34,2213,165.53,2396503,179258.42,2996,2831,0.39,333,132,0
1303,南亞         ,20170628,-9,-0.67,30557,2300.94,2322,174.85,2398897,180636.94,1668,1611,0.39,0,9,0
1303,南亞         ,20170629,71,5.35,30628,2309.35,582,43.88,2399479,180920.72,1445,943,0.39,75,4,0
1303,南亞         ,20170630,725,54.74,36600,2763.3,1832,138.32,2382949,179912.65,2751,1673,0.46,725,0,0
1303,南亞         ,20170703,-21,-1.59,36579,2761.71,1822,137.56,2384772,180050.29,2144,1944,0.46,0,21,0
1303,南亞         ,20170704,-87,-6.53,36492,2736.9,322,24.15,2385094,178882.05,1404,2803,0.46,9,96,0
1303,南亞         ,20170705,-55,-4.17,36437,2761.92,4357,330.26,2389451,181120.39,4231,1753,0.46,0,55,0
1303,南亞         ,20170706,-141,-10.66,36296,2743.98,417,31.53,2389868,180674.02,2270,2090,0.46,196,337,0
1303,南亞         ,20170707,-49,-3.68,36247,2722.15,-593,-44.53,2389276,179434.63,1091,1850,0.46,73,122,0
1303,南亞         ,20170710,88,6.56,36335,2710.59,-746,-55.65,2388529,178184.26,1836,2699,0.46,95,7,0
1303,南亞         ,20170711,-318,-24.07,36017,2726.49,2779,210.37,2391308,181022.02,3345,1567,0.45,20,338,0
1303,南亞         ,20170712,200,15.47,36217,2803.2,2064,159.75,2393372,185246.99,4821,3131,0.46,225,25,0
1303,南亞         ,20170713,-134,-10.4,36083,2800.04,1722,133.63,2395094,185859.29,3343,3810,0.45,1,135,0
1303,南亞         ,20170714,-115,-8.89,35968,2780.33,2354,181.96,2397271,185309.05,1390,2178,0.45,0,115,0
1303,南亞         ,20170717,-2,-0.13,35966,2798.15,8306,646.21,2405577,187153.89,3176,3315,0.45,0,2,0
1303,南亞         ,20170718,-14,-1.04,35952,2667.64,749,55.58,2406326,178549.39,6447,1107,0.45,36,50,0
1303,南亞         ,20170719,-115,-8.58,35837,2673.44,-2256,-168.3,2404060,179342.88,3755,4088,0.45,0,115,0
1303,南亞         ,20170720,55,4.13,35892,2691.9,414,31.05,2404474,180335.55,1939,1459,0.45,205,150,0
1303,南亞         ,20170721,-1,-0.07,35891,2684.65,652,48.77,2405126,179903.42,1479,706,0.45,0,1,0
1303,南亞         ,20170724,-125,-9.39,35766,2686.03,1486,111.6,2407009,180766.38,3056,814,0.45,0,125,0
1303,南亞         ,20170725,-147,-10.95,35619,2653.62,271,20.19,2408174,179408.96,1220,749,0.45,3,150,0
1303,南亞         ,20170726,-428,-31.89,35191,2621.73,163,12.14,2410619,179591.12,2598,1642,0.44,0,428,0
1303,南亞         ,20170727,0,0,35191,2656.92,5182,391.24,2416695,182460.47,6056,943,0.44,0,0,0
1303,南亞         ,20170728,430,32.47,35621,2689.39,-52,-3.93,2416980,182481.99,608,992,0.45,430,0,0
1303,南亞         ,20170731,397,30.17,36018,2737.37,1575,119.7,2404179,182717.6,5072,3835,0.45,397,0,0
1303,南亞         ,20170801,-20,-1.52,35998,2735.85,1617,122.89,2405899,182848.32,4207,2514,0.45,7,27,0
1303,南亞         ,20170802,-768,-57.91,35230,2656.34,-832,-62.73,2405191,181351.4,2178,2135,0.44,8,776,0
1303,南亞         ,20170803,-446,-33.63,34784,2622.71,765,57.68,2406290,181434.27,3676,2141,0.44,11,457,0
1303,南亞         ,20170804,-161,-12.2,34623,2624.42,-792,-60.03,2406600,182420.28,2152,1692,0.44,19,180,0
1303,南亞         ,20170807,11,0.84,34634,2632.18,-1195,-90.82,2407035,182934.66,626,213,0.44,11,0,0
1303,南亞         ,20170808,-36,-2.75,34598,2643.29,534,40.8,2409211,184063.72,2899,706,0.44,17,53,0
1303,南亞         ,20170809,175,13.34,34773,2649.7,-569,-43.36,2410454,183676.59,1776,738,0.44,204,29,0
1303,南亞         ,20170810,61,4.6,34834,2626.48,-770,-58.06,2411428,181821.67,2075,1180,0.44,61,0,0
1303,南亞         ,20170811,-349,-26.11,34485,2579.48,-357,-26.7,2411124,180352.08,1270,1235,0.43,4,353,0
1303,南亞         ,20170814,-252,-18.67,34233,2536.67,1090,80.77,2412264,178748.76,1895,531,0.43,0,252,0
1303,南亞         ,20170815,174,12.96,34407,2563.32,1481,110.33,2415274,179937.91,3569,733,0.43,176,2,0
1303,南亞         ,20170816,825,60.64,35232,2589.55,-1308,-96.14,2415715,177555.05,3745,4145,0.44,825,0,0.01
1303,南亞         ,20170817,-259,-19.3,34973,2605.49,2959,220.45,2420649,180338.35,6935,1508,0.44,1,260,0
1303,南亞         ,20170818,-1,-0.07,34972,2619.4,-594,-44.49,2422177,181421.06,4234,2705,0.44,0,1,0
1303,南亞         ,20170821,45,3.4,35017,2647.29,-722,-54.58,2423544,183219.93,4207,2902,0.44,45,0,0
1303,南亞         ,20170822,0,0,35017,2647.29,-195,-14.74,2425532,183370.22,4608,2661,0.44,0,0,0
1303,南亞         ,20170823,67,5.08,35084,2659.37,-919,-69.66,2426714,183944.92,2033,1018,0.44,93,26,0
1303,南亞         ,20170824,-20,-1.52,35064,2664.86,-1050,-79.8,2428431,184560.76,3300,1573,0.44,0,20,0
1303,南亞         ,20170825,-61,-4.59,35003,2635.73,-1367,-102.94,2428904,182896.47,2033,1297,0.44,0,61,0
1303,南亞         ,20170828,-6,-0.46,34997,2659.77,102,7.75,2430528,184720.13,3126,1495,0.44,1,7,0
1303,南亞         ,20170829,93,7.09,35090,2673.86,44,3.35,2432227,185335.7,3593,1987,0.44,100,7,0
1303,南亞         ,20170830,0,0,35090,2673.86,-2585,-196.98,2431818,185304.53,2633,3070,0.44,0,0,0
1303,南亞         ,20170831,0,0,35090,2673.86,470,35.81,2433722,185449.62,3422,2867,0.44,0,0,0
1303,南亞         ,20170901,28,2.12,35118,2661.94,-1094,-82.93,2432790,184405.48,1362,2322,0.44,33,5,0
1303,南亞         ,20170904,-600,-45,34518,2588.85,-1320,-99,2431642,182373.15,2673,3221,0.44,0,600,0
1303,南亞         ,20170905,-598,-45.03,33920,2554.18,-938,-70.63,2430852,183043.16,5832,6025,0.43,2,600,0
1303,南亞         ,20170906,-4,-0.3,33916,2543.7,-771,-57.83,2432115,182408.63,7024,6465,0.43,0,4,0
1303,南亞         ,20170907,57,4.3,33973,2564.96,-1132,-85.47,2432008,183616.6,5773,5937,0.43,57,0,0
1303,南亞         ,20170908,1,0.08,33974,2565.04,-1170,-88.34,2433219,183708.03,7883,7873,0.43,41,40,0
1303,南亞         ,20170911,30,2.27,34004,2567.3,-4100,-309.55,2430342,183490.82,4011,6917,0.43,30,0,0
1303,南亞         ,20170912,116,8.76,34120,2576.06,-4282,-323.29,2427255,183257.75,4603,7842,0.43,116,0,0
1303,南亞         ,20170913,13,0.98,34133,2577.04,-5758,-434.73,2422449,182894.9,4330,9043,0.43,13,0,0
1303,南亞         ,20170914,162,12.23,34295,2589.27,-4647,-350.85,2417885,182550.32,4029,8755,0.43,162,0,0
1303,南亞         ,20170915,311,23.54,34606,2619.67,-514,-38.91,2417173,182980,9870,10932,0.44,314,3,0
1303,南亞         ,20170918,1409,108.07,36015,2762.35,2406,184.54,2419463,185572.81,4664,3783,0.45,1412,3,0.01
1303,南亞         ,20170919,116,8.87,36131,2764.02,1570,120.11,2420521,185169.86,7546,6043,0.46,126,10,0
1303,南亞         ,20170920,102,7.8,36233,2771.82,987,75.51,2421497,185244.52,4653,3789,0.46,102,0,0
1303,南亞         ,20170921,67,5.13,36300,2776.95,-861,-65.87,2420428,185162.74,4733,5869,0.46,67,0,0
1303,南亞         ,20170922,90,6.88,36390,2780.2,-1535,-117.27,2420160,184900.22,3012,3370,0.46,90,0,0
1303,南亞         ,20170925,67,5.05,36457,2748.86,-1833,-138.21,2418687,182369,2561,2961,0.46,67,0,0
1303,南亞         ,20170926,702,53,37159,2805.5,-94,-7.1,2419551,182676.1,3673,3450,0.47,702,0,0
1303,南亞         ,20170927,94,7.06,37253,2797.7,-2430,-182.49,2418084,181598.11,2469,3973,0.47,94,0,0
1303,南亞         ,20170928,8,0.59,37261,2753.59,-4404,-325.46,2414747,178449.8,2584,5815,0.47,8,0,0
1303,南亞         ,20170929,-2,-0.15,37259,2783.25,95,7.1,2414692,180377.49,3380,3319,0.47,0,2,0
1303,南亞         ,20170930,0,0,32479,2435.93,-11,-0.83,2409912,180743.4,1100,1100,0.41,0,0,0
1303,南亞         ,20171002,117,8.7,32596,2425.14,-2745,-204.23,2407394,179110.11,2039,3262,0.41,117,0,0
1303,南亞         ,20171003,-30,-2.22,32566,2409.88,-2019,-149.41,2407687,178168.84,3971,3790,0.41,20,50,0
1303,南亞         ,20171005,84,6.17,32650,2399.78,1980,145.53,2409697,177112.73,3995,2080,0.41,97,13,0
1303,南亞         ,20171006,34,2.5,32684,2399.01,220,16.15,2409925,176888.5,4456,4262,0.41,34,0,0
1303,南亞         ,20171011,193,14.44,32877,2459.2,1652,123.57,2411757,180399.42,8931,7293,0.41,200,7,0
1303,南亞         ,20171012,211,15.83,33088,2481.6,984,73.8,2412909,180968.18,8734,7793,0.42,211,0,0
1303,南亞         ,20171013,62,4.6,33150,2459.73,-2007,-148.92,2410881,178887.37,2200,4289,0.42,62,0,0
1303,南亞         ,20171016,-59,-4.44,33091,2491.75,2427,182.75,2413330,181723.75,4841,2333,0.42,106,165,0
1303,南亞         ,20171017,-45,-3.39,33046,2491.67,1778,134.06,2415099,182098.46,3984,2170,0.42,0,45,0
1303,南亞         ,20171018,338,25.25,33384,2493.78,-533,-39.82,2414591,180369.95,3737,4583,0.42,382,44,0
1303,南亞         ,20171019,-110,-8.22,33274,2485.57,185,13.82,2414757,180382.35,2383,2107,0.42,0,110,0
1303,南亞         ,20171020,137,10.28,33411,2505.83,276,20.7,2415098,181132.35,2512,2348,0.42,137,0,0
1303,南亞         ,20171023,182,13.54,33593,2499.32,-730,-54.31,2414370,179629.13,558,1467,0.42,255,73,0
1303,南亞         ,20171024,-6,-0.45,33587,2519.03,775,58.13,2415108,181133.1,2072,1319,0.42,0,6,0
1303,南亞         ,20171025,-838,-62.6,32749,2446.35,-1605,-119.89,2414348,180351.8,764,1496,0.41,310,1148,0.01
1303,南亞         ,20171026,-154,-11.47,32595,2428.33,-456,-33.97,2413891,179834.88,1142,1446,0.41,0,154,0
1303,南亞         ,20171027,389,28.86,32984,2447.41,-894,-66.33,2412991,179043.93,730,2018,0.42,786,397,0.01
1303,南亞         ,20171030,-340,-25.02,32644,2402.6,-1751,-128.87,2411202,177464.47,1244,2693,0.41,0,340,0
1303,南亞         ,20171031,1,0.07,32645,2428.79,397,29.54,2412136,179462.92,3883,3468,0.41,1,0,0
1303,南亞         ,20171101,-14,-1.05,32631,2444.06,605,45.31,2412740,180714.23,3065,2450,0.41,0,14,0
1303,南亞         ,20171102,-9,-0.7,32622,2446.65,388,29.1,2413206,180990.45,2457,1978,0.41,0,9,0
1303,南亞         ,20171103,4,0.3,32626,2446.95,-441,-33.08,2412770,180957.75,2988,3428,0.41,4,0,0
1303,南亞         ,20171106,-80,-5.97,32546,2427.93,-1383,-103.17,2411389,179889.62,2787,4088,0.41,0,80,0
1303,南亞         ,20171107,0,0,32546,2444.2,655,49.19,2412357,181168.01,3312,2672,0.41,0,0,0
1303,南亞         ,20171108,134,10.05,32680,2451,708,53.1,2413070,180980.25,2800,2231,0.41,134,0,0
1303,南亞         ,20171109,2,0.15,32682,2441.35,617,46.09,2413638,180298.76,4712,4106,0.41,15,13,0
1303,南亞         ,20171110,17,1.27,32699,2439.35,427,31.85,2414057,180088.65,1964,1563,0.41,17,0,0
1303,南亞         ,20171113,11,0.82,32710,2443.44,442,33.02,2414459,180360.09,3652,3261,0.41,50,39,0
1303,南亞         ,20171114,-11,-0.83,32699,2452.43,790,59.25,2415262,181144.65,4520,3705,0.41,0,11,0
1303,南亞         ,20171115,145,10.83,32844,2453.45,-1139,-85.08,2414169,180338.42,3851,5089,0.41,145,0,0
1303,南亞         ,20171116,85,6.34,32929,2456.5,188,14.02,2414352,180110.66,3717,3619,0.42,85,0,0
1303,南亞         ,20171117,-1,-0.07,32928,2459.72,1237,92.4,2415620,180446.81,4161,2912,0.42,0,1,0
1303,南亞         ,20171120,0,0,32928,2463.01,-42,-3.14,2415568,180684.49,3051,3103,0.42,0,0,0
1303,南亞         ,20171121,-210,-15.79,32718,2460.39,1012,76.1,2416518,181722.15,4499,3377,0.41,0,210,0
1303,南亞         ,20171122,91,6.87,32809,2477.08,2671,201.66,2419189,182648.77,7123,4530,0.41,141,50,0
1303,南亞         ,20171123,3,0.23,32812,2477.31,600,45.3,2419791,182694.22,3061,2437,0.41,71,68,0
1303,南亞         ,20171124,0,0,32812,2477.31,-332,-25.07,2419488,182671.34,2624,2927,0.41,0,0,0
1303,南亞         ,20171127,0,0,32812,2490.43,1426,108.23,2420883,183745.02,3921,2549,0.41,0,0,0
1303,南亞         ,20171128,90,6.83,32902,2497.26,-417,-31.65,2420691,183730.45,2559,3017,0.41,100,10,0
1303,南亞         ,20171129,-60,-4.55,32842,2492.71,-776,-58.9,2419888,183669.5,2898,3670,0.41,0,60,0
1303,南亞         ,20171130,-110,-8.32,32732,2474.54,-1339,-101.23,2418715,182854.85,9446,10706,0.41,5,115,0
1303,南亞         ,20171201,5,0.38,32737,2455.28,-2461,-184.58,2416253,181218.98,2054,4558,0.41,5,0,0
1303,南亞         ,20171204,48,3.63,32785,2478.55,-1,-0.08,2416252,182668.65,2803,2819,0.41,48,0,0
1303,南亞         ,20171205,-101,-7.66,32684,2477.45,1815,137.58,2418086,183290.92,3417,1477,0.41,0,101,0
1303,南亞         ,20171206,15,1.13,32699,2452.43,-156,-11.7,2417674,181325.55,2431,2626,0.41,15,0,0
1303,南亞         ,20171207,-2,-0.15,32697,2435.93,36,2.68,2417710,180119.4,2982,2976,0.41,0,2,0
1303,南亞         ,20171208,0,0,32697,2435.93,-612,-45.59,2417033,180068.96,1486,2084,0.41,0,0,0
1303,南亞         ,20171211,70,5.19,32767,2431.31,-1654,-122.73,2415328,179217.34,590,2271,0.41,70,0,0
1303,南亞         ,20171212,151,11.2,32918,2442.52,-703,-52.16,2414717,179172,2531,3360,0.42,325,174,0
1303,南亞         ,20171213,281,20.96,33199,2476.65,-49,-3.66,2414566,180126.62,1167,1567,0.42,281,0,0
1303,南亞         ,20171214,560,42,33759,2531.93,976,73.2,2415543,181165.73,1060,697,0.43,561,1,0
1303,南亞         ,20171215,635,47.43,34394,2569.23,-950,-70.97,2414594,180370.17,6001,7696,0.43,635,0,0
1303,南亞         ,20171218,681,51.21,35075,2637.64,439,33.01,2414919,181601.91,2491,2799,0.44,681,0,0
1303,南亞         ,20171219,-1,-0.08,35074,2641.07,354,26.66,2415273,181870.06,3521,3264,0.44,0,1,0
1303,南亞         ,20171220,0,0,35074,2658.61,1178,89.29,2416618,183179.64,2834,1567,0.44,0,0,0
1303,南亞         ,20171221,38,2.88,35112,2665,877,66.56,2417432,183483.09,2658,1880,0.44,38,0,0
1303,南亞         ,20171222,0,0,35112,2675.53,1102,83.97,2418532,184292.14,3349,2262,0.44,0,0,0
1303,南亞         ,20171225,100,7.65,35212,2693.72,1232,94.25,2419764,185111.95,1319,133,0.44,100,0,0
1303,南亞         ,20171226,-30,-2.3,35182,2691.42,480,36.72,2420244,185148.67,357,86,0.44,8,38,0
1303,南亞         ,20171227,102,7.91,35284,2734.51,3061,237.23,2423305,187806.14,4306,1482,0.44,139,37,0
1303,南亞         ,20171228,3,0.23,35287,2724.16,2608,201.34,2425913,187280.48,4141,2099,0.44,13,10,0
1303,南亞         ,20171229,100,7.79,33767,2630.45,2229,173.64,2425400,188938.66,5176,3476,0.43,130,30,0
1303,南亞         ,20180102,90,6.93,33857,2606.99,-1097,-84.47,2424313,186672.1,1140,2539,0.43,90,0,0
1303,南亞         ,20180103,-76,-5.94,33781,2641.67,212,16.58,2424525,189597.86,1300,1200,0.43,28,104,0
1303,南亞         ,20180104,748,58.34,34529,2693.26,204,15.91,2424554,189115.21,1626,2200,0.44,1027,279,0.01
1303,南亞         ,20180105,-51,-3.98,34478,2689.28,1259,98.2,2425813,189213.41,2272,1004,0.43,0,51,0
1303,南亞         ,20180108,-24,-1.91,34454,2739.09,1119,88.96,2426932,192941.09,3990,3054,0.43,0,24,0
1303,南亞         ,20180109,474,38.73,34928,2853.62,3754,306.7,2430686,198587.05,5451,3181,0.44,484,10,0
1303,南亞         ,20180110,1551,128.27,36479,3016.81,3118,257.86,2433804,201275.59,4926,3507,0.46,1593,42,0.01
1303,南亞         ,20180111,0,0,36479,2991.28,1566,128.41,2435369,199700.26,4359,3236,0.46,0,0,0
1303,南亞         ,20180112,-442,-35.85,36037,2922.6,-1883,-152.71,2433487,197355.8,3788,5314,0.45,0,442,0
1303,南亞         ,20180115,78,6.4,36115,2961.43,1319,108.16,2434806,199654.09,3235,1985,0.46,90,12,0
1303,南亞         ,20180116,-38,-3.1,36077,2940.28,2027,165.2,2436813,198600.26,4231,2182,0.45,0,38,0
1303,南亞         ,20180117,0,0,36077,2940.28,-753,-61.37,2436060,198538.89,5366,3417,0.45,0,0,0
1303,南亞         ,20180118,-1141,-92.65,34936,2836.8,1225,99.47,2437297,197908.52,4024,1612,0.44,8,1149,0.01
1303,南亞         ,20180119,0,0,34936,2833.31,187,15.17,2438442,197757.65,1890,1473,0.44,0,0,0
1303,南亞         ,20180122,-899,-72.64,34037,2750.19,-1008,-81.45,2437395,196941.52,2661,2809,0.43,0,899,0.01
1303,南亞         ,20180123,0,0,34037,2753.59,386,31.23,2438021,197235.9,2248,1690,0.43,0,0,0
1303,南亞         ,20180124,-40,-3.19,33997,2729.96,-2140,-171.84,2438081,195777.9,2124,2052,0.43,0,40,0
1303,南亞         ,20180125,11,0.9,34008,2781.85,5095,416.77,2442957,199833.88,6191,1457,0.43,11,0,0
1303,南亞         ,20180126,-366,-29.87,33642,2745.19,-320,-26.11,2442582,199314.69,2317,2327,0.42,0,366,0
1303,南亞         ,20180129,0,0,33642,2758.64,77,6.31,2442670,200298.94,1610,1522,0.42,0,0,0
1303,南亞         ,20180130,244,19.8,33886,2744.77,-1024,-82.94,2441289,197744.41,1348,2626,0.43,341,97,0
1303,南亞         ,20180131,-14,-1.12,33872,2713.15,-3865,-309.59,2438787,195346.84,3382,5540,0.43,5,19,0
1303,南亞         ,20180201,3,0.24,33875,2713.39,-1665,-133.37,2437121,195213.39,2363,4034,0.43,3,0,0
1303,南亞         ,20180202,-58,-4.63,33817,2698.6,-1003,-80.04,2436444,194428.23,1917,2520,0.43,42,100,0
1303,南亞         ,20180205,0,0,33817,2664.78,-1766,-139.16,2434855,191866.57,2329,3932,0.43,0,0,0
1303,南亞         ,20180206,20,1.52,33837,2575,-9450,-719.15,2426084,184624.99,2515,11316,0.43,20,0,0
1303,南亞         ,20180207,34,2.64,33871,2631.78,-5030,-390.83,2420928,188106.11,2886,7869,0.43,34,0,0
1303,南亞         ,20180208,3,0.23,33874,2632.01,-2158,-167.68,2418620,187926.77,2080,4253,0.43,3,0,0
1303,南亞         ,20180209,0,0,33874,2574.42,-6887,-523.41,2411260,183255.76,1997,9246,0.43,0,0,0
1303,南亞         ,20180212,0,0,33874,2581.2,-3409,-259.77,2407854,183478.47,3319,6702,0.43,0,0,0
1303,南亞         ,20180221,20,1.58,33894,2677.63,1835,144.97,2409788,190373.25,4999,2917,0.43,20,0,0
1303,南亞         ,20180222,-20,-1.57,33874,2659.11,-1341,-105.27,2408292,189050.92,2143,3523,0.43,0,20,0
1303,南亞         ,20180223,-20,-1.58,33854,2677.85,335,26.5,2408650,190524.22,2941,2563,0.43,0,20,0
1303,南亞         ,20180226,-36,-2.89,33818,2715.59,785,63.04,2409359,193471.53,2224,1479,0.43,4,40,0
1303,南亞         ,20180227,-61,-4.92,33757,2720.81,502,40.46,2409994,194245.52,6359,5663,0.43,0,61,0
1303,南亞         ,20180301,33,2.61,33790,2672.79,-4294,-339.66,2405699,190290.79,3779,8261,0.43,112,79,0
1303,南亞         ,20180302,-192,-15.03,33598,2630.72,-3136,-245.55,2402563,188120.68,2457,5473,0.42,4,196,0
1303,南亞         ,20180305,-40,-3.12,33558,2620.88,-4707,-367.62,2397856,187272.55,2606,7232,0.42,0,40,0
1303,南亞         ,20180306,0,0,33558,2661.15,-525,-41.63,2397354,190110.17,6726,7330,0.42,0,0,0
1303,南亞         ,20180307,-10,-0.79,33548,2663.71,500,39.7,2397854,190389.61,3357,2850,0.42,0,10,0
1303,南亞         ,20180308,-189,-14.93,33359,2635.36,-1330,-105.07,2396524,189325.4,2585,3626,0.42,0,189,0
1303,南亞         ,20180309,63,5,33422,2650.36,-1116,-88.5,2395408,189955.85,1518,2671,0.42,83,20,0
1303,南亞         ,20180312,-68,-5.47,33354,2685,1223,98.45,2396630,192928.72,5238,4045,0.42,2,70,0
1303,南亞         ,20180313,-127,-10.29,33227,2691.39,2595,210.2,2399226,194337.31,4738,1947,0.42,0,127,0
1303,南亞         ,20180314,-139,-11.19,33088,2663.58,1054,84.85,2400279,193222.46,2691,1692,0.42,0,139,0
1303,南亞         ,20180315,-259,-20.8,32829,2636.17,63,5.06,2400342,192747.46,1798,1493,0.41,0,259,0
1303,南亞         ,20180316,2637,215.44,35466,2897.57,5631,460.05,2405988,196569.22,13043,10038,0.45,3163,526,0.02
1303,南亞         ,20180319,-64,-5.25,35402,2902.96,1433,117.51,2407420,197408.44,2528,997,0.45,2,66,0
1303,南亞         ,20180320,-103,-8.5,35299,2912.17,2836,233.97,2410256,198846.12,4425,1562,0.45,27,130,0
1303,南亞         ,20180321,-162,-13.37,35137,2898.8,3567,294.28,2413823,199140.4,4765,1029,0.44,12,174,0
1303,南亞         ,20180322,-60,-4.99,35077,2914.9,7029,584.11,2421074,201191.25,8256,1457,0.44,0,60,0
1303,南亞         ,20180323,-327,-26.88,34750,2856.45,1333,109.57,2422408,199121.94,5643,3775,0.44,0,327,0
1303,南亞         ,20180326,-314,-25.87,34436,2840.97,648,53.46,2423056,199902.12,2444,1464,0.43,12,326,0
1303,南亞         ,20180327,-290,-24.08,34146,2837.53,2264,188.14,2425319,201544.01,3688,1159,0.43,0,290,0
1303,南亞         ,20180328,-1,-0.08,34145,2816.96,-204,-16.83,2425115,200071.99,1235,1249,0.43,0,1,0
1303,南亞         ,20180329,85,6.95,34230,2800.01,-3240,-265.03,2421871,198109.05,1081,4280,0.43,85,0,0
1303,南亞         ,20180330,4,0.33,34234,2810.61,2482,203.77,2424353,199039.38,3371,878,0.43,13,9,0
1303,南亞         ,20180331,21,1.71,35477,2894.92,52,4.24,2425424,197914.6,3,8,0.45,50,29,0
1303,南亞         ,20180402,-194,-15.83,35283,2879.09,1083,88.37,2426736,198021.66,2490,1125,0.44,0,194,0
1303,南亞         ,20180403,72,5.85,35355,2874.36,2809,228.37,2429712,197535.59,4682,1823,0.45,72,0,0
1303,南亞         ,20180409,34,2.84,35389,2951.44,5929,494.48,2435597,203128.79,7822,2017,0.45,34,0,0
1303,南亞         ,20180410,-15,-1.26,35374,2964.34,3938,330,2439147,204400.52,5917,1966,0.45,0,15,0
1303,南亞         ,20180411,-188,-15.77,35186,2952.11,608,51.01,2439775,204697.12,3427,3007,0.44,50,238,0
1303,南亞         ,20180412,193,16.37,35379,3000.14,3237,274.5,2442857,207154.27,3916,1078,0.45,193,0,0
1303,南亞         ,20180413,803,67.53,36182,3042.91,588,49.45,2443445,205493.72,1593,1861,0.46,803,0,0.01
1303,南亞         ,20180416,829,69.47,37011,3101.52,907,76.01,2444256,204828.65,1008,1032,0.47,829,0,0.01
1303,南亞         ,20180417,212,17.47,37223,3067.18,917,75.56,2445173,201482.26,3224,2644,0.47,979,767,0.01
1303,南亞         ,20180418,449,37.22,37672,3123.01,3201,265.36,2448318,202965.56,3176,578,0.48,625,176,0.01
1303,南亞         ,20180419,269,22.54,37941,3179.46,6339,531.21,2454757,205708.64,6669,622,0.48,269,0,0
1303,南亞         ,20180420,91,7.57,38032,3156.66,1096,90.97,2455853,203835.8,2106,1199,0.48,123,32,0
1303,南亞         ,20180423,-15,-1.23,38017,3117.39,159,13.04,2456012,201392.98,2678,2431,0.48,4,19,0
1303,南亞         ,20180424,12,0.97,38029,3076.55,1585,128.23,2457487,198810.7,3914,2580,0.48,41,29,0
1303,南亞         ,20180425,56,4.53,38085,3081.08,1471,119,2458903,198925.25,2620,1263,0.48,72,16,0
1303,南亞         ,20180426,-1813,-146.85,36272,2938.03,-87,-7.05,2458304,199122.62,3507,1929,0.46,34,1847,0.01
1303,南亞         ,20180427,-81,-6.54,36191,2924.23,903,72.96,2459083,198693.91,2668,1659,0.46,22,103,0
1303,南亞         ,20180430,0,0,36191,2953.19,1785,145.66,2458514,200614.74,2597,933,0.46,0,0,0
1303,南亞         ,20180502,-135,-11.19,36056,2989.04,672,55.71,2459186,203866.52,3270,2538,0.45,0,135,0
1303,南亞         ,20180503,370,30.23,36426,2976,-622,-50.82,2458070,200824.32,2933,3990,0.46,370,0,0
1303,南亞         ,20180504,350,28.63,36776,3008.28,-224,-18.32,2457545,201027.18,1968,2599,0.46,350,0,0
1303,南亞         ,20180507,-338,-27.89,36438,3006.14,-785,-64.76,2456760,202682.7,1329,1682,0.46,0,338,0
1303,南亞         ,20180508,139,11.54,36577,3032.23,346,28.68,2457037,203688.37,3195,2944,0.46,139,0,0
1303,南亞         ,20180509,-263,-21.83,36314,3014.06,311,25.81,2457349,203959.97,3224,2619,0.46,100,363,0
1303,南亞         ,20180510,-169,-14.16,36145,3028.95,3302,276.71,2460773,206212.78,5480,1858,0.46,7,176,0
1303,南亞         ,20180511,203,17.25,36348,3089.58,4603,391.26,2465813,209594.11,5501,664,0.46,203,0,0
1303,南亞         ,20180514,169,14.45,36517,3122.2,1711,146.29,2467649,210983.99,3079,1598,0.46,180,11,0
1303,南亞         ,20180515,0,0,36517,3111.25,4036,343.87,2472109,210623.69,7078,2948,0.46,0,0,0
1303,南亞         ,20180516,-54,-4.67,36463,3150.4,3156,272.68,2475325,213868.08,5156,1886,0.46,0,54,0
1303,南亞         ,20180517,4,0.35,36467,3179.92,4045,352.72,2479423,216205.69,6259,2538,0.46,4,0,0
1303,南亞         ,20180518,10,0.87,36477,3184.44,-243,-21.21,2478972,216414.26,3368,3627,0.46,29,19,0
1303,南亞         ,20180521,-10,-0.87,36467,3176.28,909,79.17,2480104,216017.06,2692,1550,0.46,0,10,0
1303,南亞         ,20180522,0,0,36467,3161.69,1933,167.59,2482255,215211.51,3265,1114,0.46,0,0,0
1303,南亞         ,20180523,-30,-2.62,36437,3159.09,2076,179.99,2484271,215386.3,3841,1794,0.46,0,30,0
1303,南亞         ,20180524,-23,-2.01,36414,3182.58,1303,113.88,2485615,217242.75,3241,1874,0.46,0,23,0
1303,南亞         ,20180525,-32,-2.75,36382,3128.85,-671,-57.71,2484823,213694.78,3152,3913,0.46,0,32,0
1303,南亞         ,20180528,-492,-42.46,35890,3097.31,341,29.43,2485101,214464.22,4075,3305,0.45,0,492,0
1303,南亞         ,20180529,0,0,35890,3086.54,-185,-15.91,2484963,213706.82,3432,3689,0.45,0,0,0
1303,南亞         ,20180530,-43,-3.66,35847,3050.58,-258,-21.96,2484076,211394.87,5805,6396,0.45,0,43,0
1303,南亞         ,20180531,8,0.67,35855,3001.06,-1604,-134.25,2484300,207935.91,27200,29110,0.45,8,0,0
1303,南亞         ,20180601,0,0,35855,3051.26,4064,345.85,2488365,211759.86,4418,1462,0.45,0,0,0
1303,南亞         ,20180604,-118,-10.2,35737,3087.68,4571,394.93,2492935,215389.58,3720,2141,0.45,0,118,0
1303,南亞         ,20180605,-11,-0.95,35726,3090.3,3402,294.27,2497337,216019.65,3190,2258,0.45,0,11,0
1303,南亞         ,20180606,-82,-7.08,35644,3079.64,3487,301.28,2501023,216088.39,3901,3043,0.45,0,82,0
1303,南亞         ,20180607,1,0.09,35645,3097.55,6396,555.81,2505665,217742.29,5923,2505,0.45,11,10,0
1303,南亞         ,20180608,-84,-7.18,35561,3040.47,843,72.08,2504560,214139.88,3975,6382,0.45,0,84,0
1303,南亞         ,20180611,41,3.49,35602,3026.17,2053,174.51,2504663,212896.36,1980,3025,0.45,161,120,0
1303,南亞         ,20180612,-24,-2.05,35578,3034.8,5281,450.47,2508955,214013.86,5677,3050,0.45,0,24,0
1303,南亞         ,20180613,-43,-3.69,35535,3052.46,2814,241.72,2510533,215654.78,3570,3128,0.45,0,43,0
1303,南亞         ,20180614,0,0,35535,2992.05,-3519,-296.3,2506131,211016.23,788,7536,0.45,0,0,0
1303,南亞         ,20180615,-949,-80.29,34586,2925.98,-1078,-91.2,2508584,212226.21,8608,10723,0.44,0,949,0.01
1303,南亞         ,20180619,-455,-37.67,34131,2826.05,-3850,-318.78,2506434,207532.74,3665,9665,0.43,1172,1627,0.02
1303,南亞         ,20180620,-283,-23.91,33848,2856.77,1634,137.91,2507079,211597.47,3653,4353,0.43,0,283,0
1303,南亞         ,20180621,-94,-7.91,33754,2842.09,331,27.87,2506415,211040.14,3549,4248,0.43,0,94,0
1303,南亞         ,20180622,-7,-0.59,33747,2855,-444,-37.56,2503612,211805.58,3007,3636,0.43,0,7,0
1303,南亞         ,20180625,0,0,33747,2868.5,-1396,-118.66,2501221,212603.79,1388,3102,0.43,0,0,0
1303,南亞         ,20180626,3,0.26,33750,2882.25,-726,-62,2499129,213425.62,2743,3723,0.43,3,0,0
1303,南亞         ,20180627,-63,-5.39,33687,2880.24,-2485,-212.47,2494944,213317.71,2051,4472,0.42,8,71,0
1303,南亞         ,20180628,0,0,33687,2846.55,-2163,-182.77,2492781,210639.99,3443,5633,0.42,0,0,0
1303,南亞         ,20180629,-5,-0.44,46653,4068.14,3819,333.02,2473386,215679.26,7877,4263,0.59,0,5,0
1303,南亞         ,20180702,-9,-0.79,46644,4072.02,-2383,-208.04,2471003,215718.56,2647,5092,0.59,0,9,0
1303,南亞         ,20180703,-384,-33.79,46260,4070.88,-4413,-388.34,2466235,217028.68,2658,6983,0.58,0,384,0
1303,南亞         ,20180704,-14,-1.23,46246,4069.65,-2053,-180.66,2464182,216848.02,1913,4204,0.58,0,14,0
1303,南亞         ,20180705,7,0.62,46253,4070.26,1487,130.86,2465669,216978.87,4091,2665,0.58,7,0,0
1303,南亞         ,20180706,-1,-0.09,46252,4028.55,-2874,-250.33,2462795,214509.44,2575,5590,0.58,0,1,0
1303,南亞         ,20180709,0,0,46252,4047.05,3773,330.14,2466568,215824.7,3926,3320,0.58,0,0,0
1303,南亞         ,20180710,-162,-13.4,46090,3811.64,227,18.77,2466795,204003.95,3792,2534,0.58,0,162,0
1303,南亞         ,20180711,0,0,46090,3866.95,3565,299.1,2469270,207171.75,5089,1163,0.58,0,0,0
1303,南亞         ,20180712,-8,-0.68,46082,3903.15,3533,299.25,2472803,209446.41,5765,2126,0.58,0,8,0
1303,南亞         ,20180713,-10,-0.85,46072,3916.12,1824,155.04,2475411,210409.94,3504,1584,0.58,0,10,0
1303,南亞         ,20180716,0,0,46072,3893.08,970,81.97,2476381,209254.19,2335,1255,0.58,0,0,0
1303,南亞         ,20180717,-53,-4.46,46019,3870.2,686,57.69,2477091,208323.35,3874,2949,0.58,0,53,0
1303,南亞         ,20180718,-9,-0.77,46010,3938.46,1787,152.97,2480250,212309.4,5555,3304,0.58,0,9,0
1303,南亞         ,20180719,0,0,46010,3860.24,-601,-50.42,2481428,208191.81,3025,3399,0.58,0,0,0
1303,南亞         ,20180720,-237,-19.91,45773,3844.93,-308,-25.87,2481555,208450.62,2641,2572,0.58,0,237,0
1303,南亞         ,20180723,-51,-4.27,45722,3826.93,-660,-55.24,2481343,207688.41,2431,2995,0.58,0,51,0
1303,南亞         ,20180724,51,4.3,45773,3863.24,1030,86.93,2482373,209512.28,2709,1605,0.58,51,0,0
1303,南亞         ,20180725,42,3.51,45815,3830.13,-547,-45.73,2481062,207416.78,1265,1821,0.58,42,0,0
1303,南亞         ,20180726,-51,-4.29,45764,3848.75,1743,146.59,2482649,208790.78,2728,942,0.58,38,89,0
1303,南亞         ,20180727,-20,-1.68,45744,3847.07,719,60.47,2483368,208851.25,2692,1944,0.58,25,45,0
1303,南亞         ,20180730,-29,-2.44,45715,3849.2,2557,215.3,2485925,209314.89,4284,1665,0.58,0,29,0
1303,南亞         ,20180731,-22,-1.87,45693,3879.34,3762,319.39,2488470,211271.1,5284,1489,0.58,1,23,0
1303,南亞         ,20180801,26,2.2,45719,3876.97,1046,88.7,2490240,211172.35,2973,1229,0.58,36,10,0
1303,南亞         ,20180802,-39,-3.26,45680,3818.85,-256,-21.4,2490781,208229.29,1928,1424,0.58,0,39,0
1303,南亞         ,20180803,-40,-3.35,45640,3824.63,1931,161.82,2492673,208886,2824,879,0.58,0,40,0
1303,南亞         ,20180806,-25,-2.1,45615,3831.66,1452,121.97,2494094,209503.9,2638,1192,0.58,0,25,0
1303,南亞         ,20180807,-24,-2.01,45591,3815.97,431,36.07,2494966,208828.65,3129,2232,0.57,0,24,0
1303,南亞         ,20180808,-5,-0.43,45586,3874.81,4195,356.58,2499003,212415.26,5020,648,0.57,6,11,0
1303,南亞         ,20180809,21,1.78,45607,3858.35,-486,-41.12,2498569,211378.94,1469,1925,0.58,32,11,0
1303,南亞         ,20180810,-21,-1.78,45586,3856.58,-31,-2.62,2498540,211376.48,1655,1663,0.57,0,21,0
1303,南亞         ,20180813,0,0,45586,3806.43,-538,-44.92,2497973,208580.75,1773,2340,0.57,0,0,0
1303,南亞         ,20180814,-2,-0.17,45584,3806.26,412,34.4,2500153,208762.78,3483,1301,0.57,7,9,0
1303,南亞         ,20180815,-6,-0.5,45578,3796.65,-3251,-270.81,2500304,208275.32,1327,1171,0.57,16,22,0
1303,南亞         ,20180816,0,0,45578,3741.95,-4328,-355.33,2499256,205188.92,1882,2930,0.57,0,0,0
1303,南亞         ,20180817,0,0,45578,3796.65,-410,-34.15,2502306,208442.09,4460,1691,0.57,0,0,0
1303,南亞         ,20180820,0,0,45578,3787.53,-1649,-137.03,2503774,208063.62,2949,1481,0.57,0,0,0
1303,南亞         ,20180821,-12,-1,45566,3795.65,-2065,-172.01,2505383,208698.4,2648,1027,0.57,5,17,0
1303,南亞         ,20180822,-115,-9.65,45451,3813.34,-1827,-153.29,2507524,210381.26,3456,1200,0.57,0,115,0
1303,南亞         ,20180823,-443,-37.43,45008,3803.18,-1647,-139.17,2511145,212191.75,4014,1987,0.57,0,443,0
1303,南亞         ,20180824,0,0,45008,3798.68,-3754,-316.84,2511090,211936,1390,1867,0.57,0,0,0
1303,南亞         ,20180827,0,0,45008,3816.68,-2292,-194.36,2511944,213012.85,1792,939,0.57,0,0,0
1303,南亞         ,20180828,-9,-0.77,44999,3833.91,-103,-8.78,2514940,214272.89,4349,1344,0.57,0,9,0
1303,南亞         ,20180829,60,5.12,45059,3848.04,333,28.44,2516907,214943.86,2313,574,0.57,60,0,0
1303,南亞         ,20180830,0,0,45059,3807.49,-2625,-221.81,2514361,212463.5,1795,4341,0.57,0,0,0
1303,南亞         ,20180831,3,0.26,45062,3848.29,2384,203.59,2516948,214947.36,5348,2953,0.57,3,0,0
1303,南亞         ,20180903,0,0,45062,3812.25,-1474,-124.7,2515525,212813.42,683,2106,0.57,0,0,0
1303,南亞         ,20180904,-5,-0.42,45057,3807.32,-156,-13.18,2515369,212548.68,1136,1287,0.57,0,5,0
1303,南亞         ,20180905,-31,-2.59,45026,3759.67,-2982,-249,2512820,209820.47,2064,4582,0.57,0,31,0
1303,南亞         ,20180906,3,0.25,45029,3782.44,142,11.93,2512931,211086.2,2828,2721,0.57,3,0,0
1303,南亞         ,20180907,23,1.94,45052,3757.34,-988,-82.4,2513539,209629.15,2155,3200,0.57,23,0,0
1303,南亞         ,20180910,0,0,45052,3757.34,1862,155.29,2515476,209790.7,4268,2410,0.57,0,0,0
1303,南亞         ,20180911,293,24.61,45345,3808.98,4331,363.8,2519471,211635.56,5986,2109,0.57,293,0,0
1303,南亞         ,20180912,24,2.01,45369,3792.85,2414,201.81,2521494,210796.9,3419,1441,0.57,24,0,0
1303,南亞         ,20180913,11,0.93,45380,3839.15,2998,253.63,2524408,213564.92,4433,2151,0.57,11,0,0
1303,南亞         ,20180914,136,11.42,45516,3823.34,2356,197.9,2526764,212248.18,4270,2002,0.57,136,0,0
1303,南亞         ,20180917,11,0.92,45527,3819.72,1490,125.01,2528197,212115.73,2169,668,0.57,11,0,0
1303,南亞         ,20180918,-60,-5.06,45467,3837.41,2199,185.6,2530437,213568.88,3808,1541,0.57,0,60,0
1303,南亞         ,20180919,0,0,45467,3855.6,3529,299.26,2533966,214880.32,4161,648,0.57,0,0,0
1303,南亞         ,20180920,-5,-0.42,45462,3818.81,-964,-80.98,2536067,213029.63,957,1912,0.57,0,5,0
1303,南亞         ,20180921,182,15.56,45644,3902.56,4360,372.78,2540423,217206.17,9439,4897,0.58,253,71,0
1303,南亞         ,20180925,31,2.62,45675,3859.54,539,45.55,2540962,214711.29,3115,2456,0.58,78,47,0
1303,南亞         ,20180926,40,3.36,45715,3840.06,1198,100.63,2542160,213541.44,1751,533,0.58,40,0,0
1303,南亞         ,20180927,40,3.4,45755,3889.18,2425,206.13,2544465,216279.53,5037,2800,0.58,40,0,0
1303,南亞         ,20180928,-14,-1.19,35195,2984.54,788,66.82,2534671,214940.1,5271,4197,0.44,4,18,0
1303,南亞         ,20181001,78,6.63,35273,2998.21,1416,120.36,2536134,215571.39,2364,980,0.44,78,0,0
1303,南亞         ,20181002,-8,-0.67,35265,2962.26,-2668,-224.11,2533578,212820.55,1705,4253,0.44,0,8,0
1303,南亞         ,20181003,4,0.34,35269,2955.54,565,47.35,2534267,212371.57,1739,1054,0.44,4,0,0
1303,南亞         ,20181004,4,0.33,35273,2931.19,-4464,-370.96,2529823,210228.29,2034,6482,0.44,4,0,0
1303,南亞         ,20181005,10,0.86,35283,2896.73,-2151,-176.6,2527521,207509.47,2507,4819,0.44,10,0,0
1303,南亞         ,20181008,18,1.48,35301,2898.21,-835,-68.55,2526547,207429.51,1229,2221,0.45,18,0,0
1303,南亞         ,20181009,-22,-1.8,35279,2882.29,-3180,-259.81,2523271,206151.24,1889,5071,0.44,0,22,0
1303,南亞         ,20181011,34,2.58,35313,2687.32,-11129,-846.92,2512740,191219.51,5623,16205,0.45,34,0,0
1303,南亞         ,20181012,-135,-10.52,35178,2740.37,-4864,-378.91,2506597,195263.91,2503,7249,0.44,0,135,0
1303,南亞         ,20181015,0,0,35178,2691.12,-5945,-454.79,2500275,191271.04,1599,7676,0.44,0,0,0
1303,南亞         ,20181016,38,2.93,35216,2711.63,-3219,-247.86,2496214,192208.48,1225,4496,0.44,38,0,0
1303,南亞         ,20181017,70,5.37,35286,2706.44,-3362,-257.87,2492423,191168.84,1453,4748,0.44,70,0,0
1303,南亞         ,20181018,-33,-2.53,35253,2703.91,-1480,-113.52,2488781,190889.5,2071,3491,0.44,12,45,0
1303,南亞         ,20181019,5,0.38,35258,2697.24,-1172,-89.66,2487667,190306.53,2982,4102,0.44,5,0,0
1303,南亞         ,20181022,5,0.38,35263,2694.09,-189,-14.44,2487487,190044.01,1481,1666,0.44,5,0,0
1303,南亞         ,20181023,16,1.24,35279,2652.98,-3192,-240.04,2484448,186830.49,888,4090,0.44,22,6,0
1303,南亞         ,20181024,-97,-7.31,35182,2652.72,-1910,-144.01,2482604,187188.34,1154,2901,0.44,3,100,0
1303,南亞         ,20181025,-31,-2.26,35151,2601.17,-588,-43.51,2481718,183647.13,2086,2611,0.44,19,50,0
1303,南亞         ,20181026,64,4.81,35215,2644.65,311,23.36,2482119,186407.14,2866,2579,0.44,64,0,0
1303,南亞         ,20181029,-189,-14.33,35026,2654.97,-460,-34.87,2480899,188052.14,2337,2665,0.44,1,190,0
1303,南亞         ,20181030,10,0.76,35036,2652.23,-128,-9.69,2480705,187789.37,3933,4137,0.44,10,0,0
1303,南亞         ,20181031,7,0.54,35043,2694.81,-249,-19.15,2480182,190726,3634,4024,0.44,7,0,0
1303,南亞         ,20181101,0,0,35043,2698.31,-463,-35.65,2479727,190938.98,3279,3736,0.44,0,0,0
1303,南亞         ,20181102,-76,-5.95,34967,2723.93,-136,-10.59,2479633,193163.41,2698,2738,0.44,1,77,0
1303,南亞         ,20181105,-10,-0.78,34957,2726.65,-783,-61.07,2479641,193412,4527,4618,0.44,12,22,0
1303,南亞         ,20181106,-11,-0.85,34946,2708.32,422,32.7,2480630,192248.83,3349,2349,0.44,12,23,0
1303,南亞         ,20181107,43,3.33,34989,2708.15,-1388,-107.43,2479452,191909.58,4480,5646,0.44,43,0,0
1303,南亞         ,20181108,4,0.31,34993,2704.96,420,32.47,2479987,191703,5185,4768,0.44,4,0,0
1303,南亞         ,20181109,16,1.23,35009,2681.69,-833,-63.81,2479031,189893.77,2132,3105,0.44,16,0,0
1303,南亞         ,20181112,12,0.93,35021,2707.12,951,73.51,2480136,191714.51,1960,1078,0.44,12,0,0
1303,南亞         ,20181113,-8,-0.61,35013,2685.5,-915,-70.18,2478763,190121.12,1464,2478,0.44,0,8,0
1303,南亞         ,20181114,4,0.31,35017,2696.31,366,28.18,2479141,190893.86,1243,876,0.44,4,0,0
1303,南亞         ,20181115,4,0.31,35021,2714.13,1286,99.67,2480369,192228.6,3115,1894,0.44,4,0,0
1303,南亞         ,20181116,27,2.14,35048,2733.74,834,65.05,2481276,193539.53,2743,1972,0.44,27,0,0
1303,南亞         ,20181119,7,0.55,35055,2762.33,2202,173.52,2483454,195696.18,3646,1517,0.44,7,0,0
1303,南亞         ,20181120,-31,-2.38,35024,2735.37,1027,80.21,2484429,194033.9,2680,1675,0.44,19,50,0
1303,南亞         ,20181121,-119,-9.19,34905,2694.67,469,36.21,2484636,191813.9,1846,1379,0.44,8,127,0
1303,南亞         ,20181122,-39,-2.99,34866,2674.22,1308,100.32,2485960,190673.13,2602,1254,0.44,11,50,0
1303,南亞         ,20181123,9,0.69,34875,2667.94,654,50.03,2486610,190225.67,2163,1522,0.44,9,0,0
1303,南亞         ,20181126,0,0,34875,2647.01,725,55.03,2487323,188787.82,3431,2754,0.44,0,0,0
1303,南亞         ,20181127,-25,-1.87,34850,2606.78,-2674,-200.02,2484767,185860.57,2927,5444,0.44,0,25,0
1303,南亞         ,20181128,-732,-54.73,34118,2552.03,-4078,-305.03,2480823,185565.56,4245,7979,0.43,7,739,0
1303,南亞         ,20181129,-15,-1.11,34103,2533.85,-1949,-144.81,2478968,184187.32,3436,5361,0.43,27,42,0
1303,南亞         ,20181130,1,0.07,34104,2533.93,-1106,-82.18,2477060,184045.56,8268,9411,0.43,1,0,0
1303,南亞         ,20181203,16,1.19,34120,2538.53,-5172,-384.8,2471888,183908.47,4872,10211,0.43,16,0,0
1303,南亞         ,20181204,3,0.22,34123,2531.93,-1568,-116.35,2470320,183297.74,5069,6660,0.43,3,0,0
1303,南亞         ,20181205,0,0,34123,2514.87,-4319,-318.31,2466121,181753.12,2970,6999,0.43,0,0,0
1303,南亞         ,20181206,-68,-4.93,34055,2468.99,-4987,-361.56,2461353,178448.09,3065,7765,0.43,15,83,0
1303,南亞         ,20181207,28,2.05,34083,2494.88,-350,-25.62,2461041,180148.2,1482,2027,0.43,28,0,0
1303,南亞         ,20181210,19,1.4,34102,2475.81,-1066,-77.39,2459053,178527.25,2302,3403,0.43,19,0,0
1303,南亞         ,20181211,149,10.8,34251,2483.2,-1980,-143.55,2457229,178149.1,3504,5621,0.43,209,60,0
1303,南亞         ,20181212,3,0.22,34254,2479.99,-3720,-269.33,2452477,177559.33,3915,7902,0.43,3,0,0
1303,南亞         ,20181213,0,0,34254,2500.54,-829,-60.52,2451648,178970.3,3161,4054,0.43,0,0,0
1303,南亞         ,20181214,7,0.51,34261,2501.05,-1117,-81.54,2450552,178890.3,3368,4169,0.43,7,0,0
1303,南亞         ,20181217,0,0,34261,2511.33,-1,-0.07,2450406,179614.76,3485,3490,0.43,0,0,0
1303,南亞         ,20181218,722,53.07,34983,2571.25,392,28.81,2450890,180140.42,3121,3556,0.44,722,0,0
1303,南亞         ,20181219,100,7.44,35083,2610.18,2074,154.31,2452745,182484.23,3507,1556,0.44,100,0,0
1303,南亞         ,20181220,6,0.45,35089,2610.62,888,66.07,2456852,182789.79,2347,1481,0.44,6,0,0
1303,南亞         ,20181221,108,8,35197,2608.1,629,46.61,2457480,182099.27,4812,4297,0.44,184,76,0
1303,南亞         ,20181222,4,0.29,35201,2594.31,-200,-14.74,2457325,181104.85,0,159,0.44,4,0,0
1303,南亞         ,20181224,0,0,35201,2594.31,427,31.47,2457581,181123.72,1328,909,0.44,0,0,0
1303,南亞         ,20181225,4,0.3,35205,2555.88,-1232,-89.44,2456583,178347.93,323,1270,0.44,7,3,0
1303,南亞         ,20181226,-109,-7.89,35096,2540.95,-533,-38.59,2455953,177811,103,246,0.44,0,109,0
1303,南亞         ,20181227,21,1.55,35117,2598.66,2235,165.39,2458155,181903.47,3415,1233,0.44,21,0,0
1303,南亞         ,20181228,0,0,45139,3407.99,939,70.89,2469260,186429.13,4294,3294,0.57,0,0,0
1303,南亞         ,20190102,16,1.17,45155,3296.32,-1265,-92.35,2468339,180188.75,1332,2201,0.57,16,0,0
1303,南亞         ,20190103,0,0,45155,3309.86,313,22.94,2468421,180935.26,2425,2203,0.57,0,0,0
1303,南亞         ,20190104,8,0.58,45163,3301.42,9,0.66,2468114,180419.13,2942,3233,0.57,8,0,0
1303,南亞         ,20190107,10,0.75,45173,3392.49,2543,190.98,2470503,185534.78,5643,3324,0.57,10,0,0
1303,南亞         ,20190108,12,0.89,45185,3352.73,-466,-34.58,2470084,183280.23,3743,4224,0.57,12,0,0
1303,南亞         ,20190109,0,0,45185,3366.28,-1683,-125.38,2469063,183945.19,7690,10078,0.57,0,0,0
1303,南亞         ,20190110,9,0.67,45194,3380.51,1083,81.01,2470336,184781.13,3691,2603,0.57,9,0,0
1303,南亞         ,20190111,90,6.74,45284,3391.77,1138,85.24,2471511,185116.17,3280,2320,0.57,90,0,0
1303,南亞         ,20190114,0,0,45284,3400.83,312,23.43,2471823,185633.91,1670,1351,0.57,0,0,0
1303,南亞         ,20190115,-24,-1.8,45260,3430.71,2783,210.95,2474926,187599.39,6051,3329,0.57,29,53,0
1303,南亞         ,20190116,0,0,45260,3417.13,830,62.67,2475504,186900.55,4217,3341,0.57,0,0,0
1303,南亞         ,20190117,0,0,45260,3394.5,358,26.85,2475940,185695.5,3307,2907,0.57,0,0,0
1303,南亞         ,20190118,-11,-0.83,45249,3420.82,1660,125.5,2477600,187306.56,4599,2977,0.57,0,11,0
1303,南亞         ,20190121,-382,-29.03,44867,3409.89,1600,121.6,2479354,188430.9,3010,1255,0.57,0,382,0
1303,南亞         ,20190122,-16,-1.22,44851,3426.62,287,21.93,2477794,189303.46,2562,2147,0.57,0,16,0
1303,南亞         ,20190123,-23,-1.72,44828,3344.17,-4351,-324.58,2475496,184672,2550,6782,0.57,1,24,0
1303,南亞         ,20190124,-413,-30.81,44415,3313.36,-1432,-106.83,2473929,184555.1,4640,5659,0.56,57,470,0
1303,南亞         ,20190125,-13,-0.98,44402,3361.23,1847,139.82,2472271,187150.91,5339,3507,0.56,0,13,0
1303,南亞         ,20190128,-473,-36.04,43929,3347.39,837,63.78,2473531,188483.06,3272,1860,0.55,0,473,0
1303,南亞         ,20190129,0,0,43929,3347.39,576,43.89,2473556,188484.97,5854,5276,0.55,0,0,0
1303,南亞         ,20190130,-41,-3.13,43888,3348.65,327,24.95,2472943,188685.55,6820,6376,0.55,0,41,0
1303,南亞         ,20190211,6,0.45,43894,3270.1,-2317,-172.62,2470860,184079.07,4935,7300,0.55,6,0,0
1303,南亞         ,20190212,0,0,43894,3292.05,-471,-35.33,2470310,185273.25,2739,3169,0.55,0,0,0
1303,南亞         ,20190213,4,0.3,43898,3287.96,-1429,-107.03,2468580,184896.64,3243,4666,0.55,8,4,0
1303,南亞         ,20190214,0,0,43898,3274.79,-1736,-129.51,2466832,184025.67,1215,2950,0.55,0,0,0
1303,南亞         ,20190215,6,0.45,43904,3270.85,-1367,-101.84,2465551,183683.55,2002,3392,0.55,6,0,0
1303,南亞         ,20190218,-40,-2.99,43864,3281.03,-168,-12.57,2466063,184461.51,1757,1878,0.55,0,40,0
1303,南亞         ,20190219,-24,-1.8,43840,3292.38,278,20.88,2466358,185223.49,1502,1198,0.55,0,24,0
1303,南亞         ,20190220,-66,-4.98,43774,3300.56,486,36.64,2466919,186005.69,3012,2451,0.55,0,66,0
1303,南亞         ,20190221,-69,-5.25,43705,3325.95,233,17.73,2467364,187766.4,2386,2048,0.55,0,69,0
1303,南亞         ,20190222,-36,-2.74,43669,3327.58,-1911,-145.62,2465789,187893.12,2673,4518,0.55,0,36,0
1303,南亞         ,20190225,-38,-2.93,43631,3342.13,1775,135.97,2468016,189050.03,3110,1288,0.55,0,38,0
1303,南亞         ,20190226,-25,-1.93,43606,3362.02,2493,192.21,2470926,190508.39,4873,2353,0.55,0,25,0
1303,南亞         ,20190227,-11,-0.85,43595,3352.46,1506,115.81,2471259,190039.82,6551,5034,0.55,10,21,0
1303,南亞         ,20190304,-7,-0.55,43588,3295.25,-2555,-193.16,2468746,186637.2,5901,8407,0.55,0,7,0
1303,南亞         ,20190305,5,0.38,43593,3278.19,-898,-67.53,2467917,185587.36,2372,3163,0.55,17,12,0
1303,南亞         ,20190306,0,0,43593,3304.35,-334,-25.32,2468278,187095.47,1319,1393,0.55,0,0,0
1303,南亞         ,20190307,63,4.8,43656,3326.59,-673,-51.28,2467836,188049.1,1229,1895,0.55,74,11,0
1303,南亞         ,20190308,92,6.96,43748,3307.35,-1231,-93.06,2466254,186448.8,602,1948,0.55,92,0,0
1303,南亞         ,20190311,0,0,43748,3302.97,-1235,-93.24,2465118,186116.41,1719,3013,0.55,0,0,0
1303,南亞         ,20190312,-12,-0.91,43736,3319.56,1792,136.01,2466748,187226.17,2817,1041,0.55,0,12,0
1303,南亞         ,20190313,-12,-0.91,43724,3323.02,-130,-9.88,2467055,187496.18,737,880,0.55,0,12,0
1303,南亞         ,20190314,-23,-1.74,43701,3303.8,-749,-56.62,2466555,186471.56,2206,2941,0.55,0,23,0
1303,南亞         ,20190315,-243,-18.47,43458,3302.81,629,47.8,2467108,187500.21,5689,4828,0.55,46,289,0
1303,南亞         ,20190318,-16,-1.22,43442,3323.31,1071,81.93,2468069,188807.28,2669,1678,0.55,0,16,0
1303,南亞         ,20190319,0,0,43442,3301.59,-1095,-83.22,2466912,187485.31,2053,3165,0.55,0,0,0
1303,南亞         ,20190320,0,0,43442,3310.28,-1477,-112.55,2465422,187865.16,2583,4120,0.55,0,0,0
1303,南亞         ,20190321,0,0,43442,3327.66,-343,-26.27,2465400,188849.64,2973,3304,0.55,0,0,0
1303,南亞         ,20190322,-63,-4.87,43379,3340.18,290,22.33,2465629,189853.43,1893,1548,0.55,0,63,0
1303,南亞         ,20190325,-16,-1.22,43363,3312.93,-518,-39.58,2465308,188349.53,1492,1967,0.55,0,16,0
1303,南亞         ,20190326,0,0,43363,3351.96,-138,-10.67,2465599,190590.8,2831,2979,0.55,0,0,0
1303,南亞         ,20190327,-44,-3.41,43319,3357.22,-384,-29.76,2465306,191061.22,1408,1852,0.55,0,44,0
1303,南亞         ,20190328,-12,-0.94,43307,3386.61,499,39.02,2465986,192840.11,3143,2652,0.55,0,12,0
1303,南亞         ,20190329,12,0.95,41451,3270.48,811,63.99,2465152,194500.49,5057,4157,0.52,12,0,0
1303,南亞         ,20190401,0,-0.03,41451,3237.32,17,1.33,2465243,192535.48,3094,3062,0.52,0,0,0
1303,南亞         ,20190402,-1,-0.08,41450,3245.54,-676,-52.93,2464723,192987.81,1309,1834,0.52,8,9,0
1303,南亞         ,20190403,18,1.41,41468,3242.8,-111,-8.68,2464605,192732.11,1568,1732,0.52,18,0,0
1303,南亞         ,20190408,0,0,41468,3230.36,-3772,-293.84,2461743,191769.78,2559,6226,0.52,0,0,0
1303,南亞         ,20190409,-128,-9.97,41340,3220.39,-448,-34.9,2461562,191755.68,2947,3267,0.52,23,151,0
1303,南亞         ,20190410,25,1.94,41365,3214.06,-1550,-120.44,2460367,191170.52,2838,5077,0.52,25,0,0
1303,南亞         ,20190411,-12,-0.92,41353,3184.18,-5293,-407.56,2455092,189042.08,1649,6896,0.52,0,12,0
1303,南亞         ,20190412,-3,-0.23,41350,3163.28,-2179,-166.69,2453509,187693.44,1492,3685,0.52,0,3,0
1303,南亞         ,20190415,0,0,41350,3171.55,-481,-36.89,2453676,188196.95,1516,2020,0.52,0,0,0
1303,南亞         ,20190416,477,36.78,41827,3224.86,-934,-72.01,2453022,189128,1740,3114,0.53,477,0,0
1303,南亞         ,20190417,-71,-5.51,41756,3240.27,-197,-15.29,2451872,190265.27,2208,2342,0.53,0,71,0
1303,南亞         ,20190418,-90,-6.96,41666,3220.78,-1636,-126.46,2451134,189472.66,4025,5458,0.53,0,90,0
1303,南亞         ,20190419,-54,-4.18,41612,3224.93,-174,-13.49,2451692,190006.13,1231,1348,0.52,0,54,0
1303,南亞         ,20190422,1,0.06,41613,3225.01,303,23.48,2452348,190056.97,978,683,0.52,1,0,0
1303,南亞         ,20190423,328,25.52,41941,3263.01,418,32.52,2452691,190819.36,1487,1396,0.53,328,0,0
1303,南亞         ,20190424,0,0,41941,3250.43,-2034,-157.64,2450960,189949.4,2768,4574,0.53,0,0,0
1303,南亞         ,20190425,136,10.61,42077,3282.01,-171,-13.34,2451336,191204.21,1725,2062,0.53,136,0,0
1303,南亞         ,20190426,229,17.93,42306,3312.56,1068,83.62,2452406,192023.39,2550,1677,0.53,229,0,0
1303,南亞         ,20190429,214,16.69,42520,3316.56,-1473,-114.89,2451040,191181.12,5002,6689,0.54,220,6,0
1303,南亞         ,20190430,-4,-0.31,42516,3320.5,1002,78.26,2452541,191543.45,5682,4657,0.54,0,4,0
1303,南亞         ,20190502,-227,-17.93,42289,3340.83,2326,183.75,2455601,193992.48,4146,1350,0.53,7,234,0
1303,南亞         ,20190503,31,2.47,42320,3334.82,-260,-20.49,2455110,193462.67,952,1200,0.53,40,9,0
1303,南亞         ,20190506,16,1.25,42336,3302.21,-1711,-133.46,2453610,191381.58,1629,3260,0.53,16,0,0
1303,南亞         ,20190507,-10,-0.76,42326,3309.89,-531,-41.52,2453008,191825.23,2654,3149,0.53,0,10,0
1303,南亞         ,20190508,-6,-0.44,42320,3284.03,-3301,-256.16,2449332,190068.16,1944,5506,0.53,0,6,0
1303,南亞         ,20190509,0,0,42320,3250.18,-5924,-454.96,2442076,187551.44,1359,7224,0.53,0,0,0
1303,南亞         ,20190510,0,0,42320,3267.1,-893,-68.94,2441350,188472.22,2501,3389,0.53,0,0,0
1303,南亞         ,20190513,19,1.45,42339,3234.7,-2709,-206.97,2439289,186361.68,1876,4795,0.53,19,0,0
1303,南亞         ,20190514,0,0,42339,3230.47,-2548,-194.41,2439616,186142.7,2975,6327,0.53,0,0,0
1303,南亞         ,20190515,0,0,42339,3247.4,-1783,-136.76,2437521,186957.86,1298,2967,0.53,0,0,0
1303,南亞         ,20190516,19,1.46,42358,3244.62,-1747,-133.82,2435798,186582.13,2792,4530,0.53,19,0,0
1303,南亞         ,20190517,-10,-0.77,42348,3239.62,-1038,-79.41,2434354,186228.08,1579,2614,0.53,7,17,0
1303,南亞         ,20190520,19,1.47,42367,3283.44,1323,102.53,2435673,188764.66,2454,1993,0.53,19,0,0
1303,南亞         ,20190521,0,0,42367,3330.05,2108,165.69,2437792,191610.45,3664,1752,0.53,0,0,0
1303,南亞         ,20190522,16,1.24,42383,3284.68,-2295,-177.86,2435524,188753.11,1338,3726,0.53,16,0,0
1303,南亞         ,20190523,23,1.79,42406,3303.43,1684,131.18,2437181,189856.4,1198,1523,0.53,23,0,0
1303,南亞         ,20190524,15,1.16,42421,3291.87,1690,131.14,2438510,189228.38,1420,1769,0.53,15,0,0
1303,南亞         ,20190527,0,0,42421,3325.81,3263,255.82,2441737,191432.18,2246,972,0.53,0,0,0
1303,南亞         ,20190528,15,1.18,42436,3326.98,1876,147.08,2443418,191563.97,13982,14121,0.54,15,0,0
1303,南亞         ,20190529,15,1.16,42451,3289.95,-227,-17.59,2444792,189471.38,2736,4551,0.54,19,4,0
1303,南亞         ,20190530,0,0,42451,3302.69,3,0.23,2439099,189761.9,3159,3183,0.54,0,0,0
1303,南亞         ,20190531,-162,-12.72,42289,3319.69,700,54.95,2428504,190637.56,3615,2678,0.53,0,162,0
1303,南亞         ,20190603,0,0,42289,3311.23,906,70.94,2429434,190224.68,3117,2300,0.53,0,0,0
1303,南亞         ,20190604,-49,-3.84,42240,3307.39,1145,89.65,2430386,190299.22,4267,3708,0.53,0,49,0
1303,南亞         ,20190605,0,0,42240,3315.84,2625,206.06,2431939,190907.21,3985,1407,0.53,0,0,0
1303,南亞         ,20190606,0,0,42240,3315.84,3860,303.01,2434583,191114.77,3619,2248,0.53,0,0,0
1303,南亞         ,20190610,0,0,42240,3282.05,1888,146.7,2435436,189233.38,3379,4646,0.53,0,0,0
1303,南亞         ,20190611,0,0,42240,3294.72,2169,169.18,2434748,189910.34,2614,3858,0.53,0,0,0
1303,南亞         ,20190612,-20,-1.59,42220,3284.72,2879,223.99,2432539,189251.53,2411,2845,0.53,34,54,0
1303,南亞         ,20190613,20,1.53,42240,3290.5,2828,220.3,2431236,189393.28,2930,3472,0.53,20,0,0
1303,南亞         ,20190614,0,0,42240,3311.62,2340,183.46,2427214,190293.58,3141,2954,0.53,0,0,0
1303,南亞         ,20190617,-26,-2.01,42214,3309.58,1383,108.43,2426040,190201.54,2893,2426,0.53,28,54,0
1303,南亞         ,20190618,-1072,-84.37,41142,3237.88,469,36.91,2423873,190758.81,3126,1910,0.52,35,1107,0.01
1303,南亞         ,20190619,-1176,-92.79,39966,3153.32,4295,338.88,2431008,191806.53,5998,1813,0.5,13,1189,0.01
1303,南亞         ,20190620,-1372,-107.7,38594,3029.63,607,47.65,2431823,190898.11,4529,3039,0.49,23,1395,0.01
1303,南亞         ,20190621,-92,-7.25,38502,3033.96,2936,231.36,2434920,191871.7,8015,5440,0.49,28,120,0
1303,南亞         ,20190624,8,0.6,38510,3057.69,4079,323.87,2438999,193656.52,4559,1243,0.49,8,0,0
1303,南亞         ,20190625,0,0,38510,3046.14,4237,335.15,2443236,193259.97,3379,1526,0.49,0,0,0
1303,南亞         ,20190626,38,2.99,38548,3029.87,3600,282.96,2446940,192329.48,1581,2154,0.49,38,0,0
1303,南亞         ,20190627,30,2.36,38578,3032.23,3563,280.05,2448302,192436.54,7377,6613,0.49,30,0,0
1303,南亞         ,20190628,-1,-0.08,61278,4816.45,-2884,-226.68,2473580,194423.39,2745,5677,0.77,0,1,0
1303,南亞         ,20190701,2,0.16,61280,4828.86,1963,154.68,2475514,195070.5,919,4848,0.77,2,0,0
1303,南亞         ,20190702,1,0.08,61281,4798.3,-1621,-126.92,2473905,193706.76,1442,7471,0.77,1,0,0
1303,南亞         ,20190703,0,0,61281,4449,-1149,-83.42,2473131,179549.31,7924,5268,0.77,0,0,0
1303,南亞         ,20190704,-7,-0.52,61274,4454.62,-1062,-77.21,2472118,179722.98,696,1751,0.77,0,7,0
1303,南亞         ,20190705,-87,-6.36,61187,4472.77,489,35.75,2473220,180792.38,2402,1821,0.77,14,101,0
1303,南亞         ,20190708,-659,-47.78,60528,4388.28,-2688,-194.88,2471979,179218.48,1654,3588,0.76,0,659,0
1303,南亞         ,20190709,14,1.01,60542,4365.08,-1306,-94.16,2471034,178161.55,999,2221,0.76,30,16,0
1303,南亞         ,20190710,32,2.31,60574,4379.5,-1742,-125.95,2470636,178626.98,2002,4247,0.76,32,0,0
1303,南亞         ,20190711,3,0.22,60577,4361.54,70,5.04,2472217,177999.62,3550,3383,0.76,17,14,0
1303,南亞         ,20190712,-4,-0.29,60573,4361.26,-2701,-194.47,2469864,177830.21,409,3106,0.76,0,4,0
1303,南亞         ,20190715,-46,-3.31,60527,4357.94,-1290,-92.88,2467198,177638.26,1518,2745,0.76,0,46,0
1303,南亞         ,20190716,23,1.65,60550,4341.44,-2965,-212.59,2467178,176896.66,1471,4426,0.76,45,22,0
1303,南亞         ,20190717,-126,-9.15,60424,4386.78,-10180,-739.07,2459897,178588.52,3765,5322,0.76,0,126,0
1303,南亞         ,20190718,24,1.74,60448,4346.21,-1718,-123.52,2462062,177022.26,1937,3209,0.76,24,0,0
1303,南亞         ,20190719,1,0.07,60449,4346.28,-169,-12.15,2461730,176998.39,1469,1439,0.76,1,0,0
1303,南亞         ,20190722,23,1.65,60472,4347.94,-3657,-262.94,2457418,176688.35,1507,1948,0.76,23,0,0
1303,南亞         ,20190723,33,2.37,60505,4338.21,-2384,-170.93,2455331,176047.23,2989,2131,0.76,33,0,0
1303,南亞         ,20190724,-19,-1.36,60486,4318.7,-4409,-314.8,2452416,175102.5,2483,3268,0.76,11,30,0
1303,南亞         ,20190725,89,6.37,60575,4337.17,-2002,-143.34,2449343,175372.96,3340,1981,0.76,89,0,0
1303,南亞         ,20190726,2,0.14,60577,4343.37,-3465,-248.44,2446847,175438.93,1459,2787,0.76,2,0,0
1303,南亞         ,20190729,41,2.94,60618,4340.25,-2785,-199.41,2444598,175033.22,1993,1940,0.76,41,0,0
1303,南亞         ,20190730,40,2.86,60658,4337.05,-2623,-187.54,2442450,174635.18,1853,1873,0.76,40,0,0
1303,南亞         ,20190731,40,2.85,60698,4327.77,-3672,-261.81,2431387,173357.89,8967,8467,0.77,40,0,0
1303,南亞         ,20190801,34,2.4,60732,4293.75,-4564,-322.67,2427801,171645.53,1285,4831,0.77,34,0,0
1303,南亞         ,20190802,0,0,60732,4233.02,-6133,-427.47,2423866,168943.46,1670,7300,0.77,0,0,0
1303,南亞         ,20190805,59,4.08,60791,4200.66,-3214,-222.09,2423593,167470.28,4661,7164,0.77,59,0,0
1303,南亞         ,20190806,76,5.19,60867,4157.22,-3417,-233.38,2423999,165559.13,3679,5830,0.77,76,0,0
1303,南亞         ,20190807,36,2.45,60903,4147.49,-4706,-320.48,2418843,164723.21,2906,7200,0.77,47,11,0
1303,南亞         ,20190808,16,1.12,60919,4148.58,-2404,-163.71,2418502,164699.99,1731,2561,0.77,16,0,0
1303,南亞         ,20190812,11,0.74,60930,4118.87,-2003,-135.4,2417181,163401.44,2136,3800,0.77,11,0,0
1303,南亞         ,20190813,9,0.58,60939,4082.91,-2716,-181.97,2415766,161856.32,3200,5822,0.77,52,43,0
1303,南亞         ,20190814,3,0.2,60942,4077.02,-3441,-230.2,2414049,161499.88,1586,4335,0.77,3,0,0
1303,南亞         ,20190815,39,2.57,60981,4024.75,-4366,-288.16,2410517,159094.12,1758,5998,0.77,39,0,0
1303,南亞         ,20190816,30,2.02,61011,4099.94,-5330,-358.18,2406830,161738.98,2156,5947,0.77,40,10,0
1303,南亞         ,20190819,-2,-0.13,61009,4087.6,-5090,-341.03,2405215,161149.41,1316,4801,0.77,0,2,0
1303,南亞         ,20190820,8,0.54,61017,4124.75,-1334,-90.18,2402357,162399.33,2250,3588,0.77,8,0,0
1303,南亞         ,20190821,-95,-6.45,60922,4136.6,-2986,-202.75,2401938,163091.59,2091,2791,0.77,22,117,0
1303,南亞         ,20190822,504,34.22,61426,4170.83,-897,-60.91,2401476,163060.22,1961,3362,0.77,504,0,0
1303,南亞         ,20190823,41,2.8,61467,4198.2,-624,-42.62,2401149,163998.48,713,1378,0.78,41,0,0
1303,南亞         ,20190826,51,3.43,61518,4134.01,-1925,-129.36,2396488,161043.99,1692,3661,0.78,79,28,0
1303,南亞         ,20190827,181,12.13,61699,4133.83,-2393,-160.33,2395144,160474.65,8891,11466,0.78,181,0,0
1303,南亞         ,20190828,88,5.91,61787,4152.09,-962,-64.65,2394943,160940.17,1327,2214,0.78,88,0,0
1303,南亞         ,20190829,46,3.11,61833,4179.91,-10,-0.68,2395372,161927.15,2703,2757,0.78,46,0,0
1303,南亞         ,20190830,-62,-4.27,61771,4249.84,1353,93.09,2397413,164942.01,4458,3047,0.78,0,62,0
1303,南亞         ,20190902,75,5.14,61846,4236.45,164,11.23,2398094,164269.44,1240,1148,0.78,75,0,0
1303,南亞         ,20190903,28,1.88,61874,4164.12,-1889,-127.13,2399850,161509.91,2398,4315,0.78,28,0,0
1303,南亞         ,20190904,86,5.88,61960,4238.06,1760,120.38,2402010,164297.48,3663,2482,0.78,86,0,0
1303,南亞         ,20190905,278,19.27,62238,4313.09,1999,138.53,2403941,166593.11,4052,2330,0.78,278,0,0
1303,南亞         ,20190906,64,4.43,62302,4311.3,-75,-5.19,2402226,166234.04,2461,2596,0.79,64,0,0
1303,南亞         ,20190909,45,3.11,62347,4308.18,456,31.51,2402985,166046.26,1810,1392,0.79,45,0,0
1303,南亞         ,20190910,7,0.49,62354,4327.37,823,57.12,2404532,166874.52,3473,2457,0.79,7,0,0
1303,南亞         ,20190911,24,1.67,62378,4329.03,690,47.89,2405645,166951.76,3726,2370,0.79,24,0,0
1303,南亞         ,20190912,142,9.85,62520,4338.89,3378,234.43,2409145,167194.66,6057,2699,0.79,142,0,0
1303,南亞         ,20190916,3,0.24,62523,4414.12,378,26.69,2408982,170074.13,3024,2637,0.79,11,8,0
1303,南亞         ,20190917,14,0.99,62537,4440.13,2344,166.42,2402890,170605.19,3591,1301,0.79,14,0,0
1303,南亞         ,20190918,27,1.88,62564,4404.51,612,43.08,2403723,169222.1,4058,3037,0.79,34,7,0
1303,南亞         ,20190919,127,8.9,62691,4394.64,1610,112.86,2406985,168729.65,3037,1577,0.79,139,12,0
1303,南亞         ,20190920,575,40.65,63266,4472.91,1763,124.64,2408113,170253.59,10278,9055,0.8,648,73,0
1303,南亞         ,20190923,1,0.07,63267,4485.63,892,63.24,2410854,170929.55,2714,1788,0.8,1,0,0
1303,南亞         ,20190924,-30,-2.15,63237,4489.83,1643,116.65,2416130,171545.23,4690,3006,0.8,7,37,0
1303,南亞         ,20190925,294,20.82,63531,4497.99,1052,74.48,2421229,171423.01,3003,2036,0.8,294,0,0
1303,南亞         ,20190926,266,18.73,63797,4491.31,1921,135.24,2422399,170536.89,3713,2057,0.8,274,8,0
1303,南亞         ,20190927,-4,-0.28,38040,2651.39,611,42.59,2395639,166976.04,2988,2252,0.48,0,4,0
1303,南亞         ,20191001,91,6.42,38131,2692.05,1772,125.1,2397517,169264.7,4064,2355,0.48,92,1,0
1303,南亞         ,20191002,25,1.75,38156,2670.92,200,14,2397887,167852.09,2033,1857,0.48,25,0,0
1303,南亞         ,20191003,23,1.61,38179,2634.35,-840,-57.96,2393867,165176.82,2390,3273,0.48,23,0,0
1303,南亞         ,20191004,0,0,38179,2653.44,1122,77.98,2394964,166450,2743,1561,0.48,0,0,0
1303,南亞         ,20191007,0,0,38179,2653.44,217,15.08,2395241,166469.25,1196,939,0.48,0,0,0
1303,南亞         ,20191008,-8,-0.56,38171,2664.34,1640,114.47,2396704,167289.94,3467,1816,0.48,0,8,0
1303,南亞         ,20191009,-23,-1.62,38148,2632.21,-385,-26.57,2397253,165410.46,2627,2202,0.48,1,24,0
1303,南亞         ,20191014,0,0,38148,2670.36,2939,205.73,2400172,168012.04,4539,1552,0.48,0,0,0
1303,南亞         ,20191015,0,0,38148,2681.8,1877,131.95,2401664,168836.98,2746,845,0.48,0,0,0
1303,南亞         ,20191016,-50,-3.55,38098,2697.34,3599,254.81,2406172,170356.98,5132,1044,0.48,0,50,0
1303,南亞         ,20191017,12,0.84,38110,2713.43,3264,232.4,2410528,171629.59,3997,738,0.48,12,0,0
1303,南亞         ,20191018,5,0.38,38115,2706.17,1605,113.96,2412407,171280.9,3607,2012,0.48,43,38,0
1303,南亞         ,20191021,-148,-10.51,37967,2699.45,2349,167.01,2414960,171703.66,3237,733,0.48,0,148,0
1303,南亞         ,20191022,27,1.94,37994,2731.77,3181,228.71,2418054,173858.08,4495,1335,0.48,27,0,0
1303,南亞         ,20191023,-33,-2.32,37961,2706.62,429,30.59,2419237,172491.6,2853,1619,0.48,4,37,0
1303,南亞         ,20191024,217,15.65,38178,2752.63,3629,261.65,2424848,174831.54,4605,989,0.48,217,0,0
1303,南亞         ,20191025,-10,-0.74,38168,2725.2,69,4.93,2423025,173003.99,2068,1968,0.48,0,10,0
1303,南亞         ,20191028,170,12.14,38338,2737.33,1905,136.02,2424849,173134.22,3127,1400,0.48,170,0,0
1303,南亞         ,20191029,-9,-0.64,38329,2740.52,1908,136.42,2426582,173500.61,2874,943,0.48,0,9,0
1303,南亞         ,20191030,13,0.94,38342,2764.46,3852,277.73,2430140,175213.09,5116,1313,0.48,13,0,0
1303,南亞         ,20191031,-12,-0.86,38330,2759.76,2207,158.9,2432250,175122,6401,4038,0.48,0,12,0
1303,南亞         ,20191101,13,0.93,38343,2753.03,475,34.1,2432814,174676.05,1791,1344,0.48,13,0,0
1303,南亞         ,20191104,284,20.53,38627,2792.73,2208,159.64,2434600,176021.58,3408,1464,0.49,294,10,0
1303,南亞         ,20191105,-12,-0.87,38615,2815.03,2111,153.89,2435356,177537.45,3354,1249,0.49,33,45,0
1303,南亞         ,20191106,70,5.08,38685,2808.53,869,63.09,2436225,176869.94,2744,2057,0.49,70,0,0
1303,南亞         ,20191107,226,16.48,38911,2836.61,2306,168.11,2438529,177768.76,3323,1225,0.49,270,44,0
1303,南亞         ,20191108,205,14.9,39116,2843.73,117,8.51,2438967,177312.9,2273,2371,0.49,205,0,0
1303,南亞         ,20191111,-2,-0.14,39114,2816.21,1083,77.98,2439954,175676.69,3355,2277,0.49,11,13,0
1303,南亞         ,20191112,-298,-21.49,38816,2798.63,855,61.65,2440843,175984.78,2913,1760,0.49,71,369,0
1303,南亞         ,20191113,-307,-21.92,38509,2749.54,-653,-46.62,2440473,174249.77,2219,2677,0.49,0,307,0
1303,南亞         ,20191114,30,2.13,38539,2736.27,-69,-4.9,2440391,173267.76,1860,1943,0.49,30,0,0
1303,南亞         ,20191115,0,0,38539,2755.54,750,53.63,2441191,174545.16,2547,1755,0.49,0,0,0
1303,南亞         ,20191118,148,10.63,38687,2777.73,284,20.39,2441434,175294.96,1842,1714,0.49,148,0,0
1303,南亞         ,20191119,-43,-3.09,38644,2778.5,-824,-59.25,2440610,175479.86,2375,3160,0.49,0,43,0
1303,南亞         ,20191120,54,3.86,38698,2763.04,-391,-27.92,2440121,174224.64,1280,1690,0.49,54,0,0
1303,南亞         ,20191121,145,10.32,38843,2757.85,-790,-56.09,2439259,173187.39,1732,2609,0.49,145,0,0
1303,南亞         ,20191122,24,1.72,38867,2778.99,448,32.03,2440268,174479.16,2283,1780,0.49,40,16,0
1303,南亞         ,20191125,7,0.5,38874,2787.27,249,17.85,2440608,174991.59,2101,1774,0.49,7,0,0
1303,南亞         ,20191126,33,2.36,38907,2785.74,2038,145.92,2442878,174910.06,18059,15861,0.49,35,2,0
1303,南亞         ,20191127,35,2.54,38942,2823.3,1307,94.76,2444037,177192.68,2971,1847,0.49,35,0,0
1303,南亞         ,20191128,7,0.5,38949,2823.8,1397,101.28,2445391,177290.85,3147,1758,0.49,7,0,0
1303,南亞         ,20191129,19,1.36,38968,2786.21,-677,-48.41,2444034,174748.43,2165,2859,0.49,19,0,0
1303,南亞         ,20191202,38,2.72,39006,2792.83,464,33.22,2444529,175028.28,1643,1205,0.49,38,0,0
1303,南亞         ,20191203,16,1.15,39022,2793.98,-426,-30.5,2444154,175001.43,1133,1575,0.49,16,0,0
1303,南亞         ,20191204,11,0.79,39033,2802.57,138,9.91,2443764,175462.26,2011,1844,0.49,11,0,0
1303,南亞         ,20191205,24,1.7,39057,2773.05,-1413,-100.32,2443472,173486.51,2095,3532,0.49,24,0,0
1303,南亞         ,20191206,-37,-2.63,39020,2778.22,-690,-49.13,2442830,173929.5,864,1519,0.49,8,45,0
1303,南亞         ,20191209,9,0.64,39029,2767.16,12,0.85,2444409,173308.6,2258,2269,0.49,17,8,0
1303,南亞         ,20191210,4,0.28,39033,2775.25,649,46.14,2443495,173732.49,1919,1266,0.49,4,0,0
1303,南亞         ,20191211,11,0.78,39044,2783.84,467,33.3,2444203,174271.67,1991,1537,0.49,11,0,0
1303,南亞         ,20191212,0,0,39044,2811.17,3676,264.67,2447200,176198.4,5432,1782,0.49,0,0,0
1303,南亞         ,20191213,-11,-0.79,39033,2818.18,2651,191.4,2448459,176778.74,4801,2159,0.49,0,11,0
1303,南亞         ,20191216,0,0,39033,2818.18,-779,-56.24,2446815,176660.04,2322,3107,0.49,0,0,0
1303,南亞         ,20191217,124,9.04,39157,2846.71,2035,147.94,2448169,177981.89,4250,2339,0.49,148,24,0
1303,南亞         ,20191218,345,25.05,39502,2867.85,580,42.11,2449081,177803.28,4958,4688,0.5,345,0,0
1303,南亞         ,20191219,138,10.06,39640,2889.76,796,58.03,2450227,178621.55,3102,2460,0.5,145,7,0
1303,南亞         ,20191220,122,8.89,39762,2898.65,1888,137.64,2452901,178816.48,8138,6430,0.5,175,53,0
1303,南亞         ,20191223,-4,-0.29,39758,2910.29,635,46.48,2456214,179794.86,2245,1613,0.5,0,4,0
1303,南亞         ,20191224,-25,-1.83,39733,2900.51,511,37.3,2460901,179645.77,1120,604,0.5,2,27,0
1303,南亞         ,20191225,0,0,39733,2900.51,574,41.9,2462018,179727.31,541,463,0.5,0,0,0
1303,南亞         ,20191226,4,0.29,39737,2892.85,332,24.17,2463171,179318.85,793,505,0.5,4,0,0
1303,南亞         ,20191227,-25,-1.83,39712,2906.92,2331,170.63,2465624,180483.68,2712,445,0.5,50,75,0
1303,南亞         ,20191230,48,3.51,39760,2910.43,931,68.15,2466624,180556.88,3056,2252,0.5,50,2,0
1303,南亞         ,20191231,42,3.06,36997,2693.38,-980,-71.34,2462413,179263.67,805,1664,0.47,42,0,0
1303,南亞         ,20200102,130,9.44,37127,2695.42,-80,-5.81,2460382,178623.73,1022,1236,0.47,139,9,0
1303,南亞         ,20200103,64,4.68,37191,2722.38,805,58.93,2462236,180235.68,2076,1224,0.47,92,28,0
1303,南亞         ,20200106,261,19.05,37452,2734,551,40.22,2462777,179782.72,1622,1312,0.47,261,0,0
1303,南亞         ,20200107,114,8.28,37566,2727.29,-615,-44.65,2462544,178780.69,1661,2346,0.47,114,0,0
1303,南亞         ,20200108,107,7.66,37673,2697.39,-1270,-90.93,2461653,176254.35,1147,2474,0.48,107,0,0
1303,南亞         ,20200109,644,46.63,38317,2774.15,-63,-4.56,2461611,178220.64,952,1660,0.48,644,0,0
1303,南亞         ,20200110,642,46.16,38959,2801.15,-82,-5.9,2459262,176820.94,1557,2299,0.49,642,0,0
1303,南亞         ,20200113,455,33.22,39414,2877.22,2191,159.94,2462337,179750.6,3286,1518,0.5,455,0,0
1303,南亞         ,20200114,487,35.55,39901,2912.77,821,59.93,2463910,179865.43,2110,1750,0.5,487,0,0
1303,南亞         ,20200115,-7,-0.51,39894,2900.29,-472,-34.31,2463789,179117.46,2826,2912,0.5,0,7,0
1303,南亞         ,20200116,20,1.46,39914,2909.73,707,51.54,2467068,179849.26,1825,1066,0.5,20,0,0
1303,南亞         ,20200117,11,0.8,39925,2914.53,517,37.74,2467000,180091,2196,1704,0.5,11,0,0
1303,南亞         ,20200120,-150,-10.92,39775,2895.62,916,66.68,2468595,179713.72,2138,1173,0.5,2,152,0
1303,南亞         ,20200130,152,10.43,39927,2738.99,-3639,-249.64,2463585,169001.93,6277,10035,0.5,733,581,0.01
1303,南亞         ,20200131,-157,-10.94,39770,2771.97,-1715,-119.54,2461712,171581.33,3621,5216,0.5,46,203,0
1303,南亞         ,20200203,119,8.15,39889,2732.4,-1081,-74.05,2460682,168556.72,3630,5025,0.5,119,0,0
1303,南亞         ,20200204,-4,-0.28,39885,2795.94,272,19.07,2460773,172500.19,3537,3225,0.5,0,4,0
1303,南亞         ,20200205,-363,-25.01,39522,2723.07,-1160,-79.92,2459689,169472.57,2888,3487,0.5,16,379,0
1303,南亞         ,20200206,307,21.57,39829,2799.98,2604,183.06,2462279,173098.21,3863,1615,0.5,307,0,0
1303,南亞         ,20200207,8,0.56,39837,2780.62,-1095,-76.43,2461705,171827.01,2748,3816,0.5,8,0,0
1303,南亞         ,20200210,0,0,39837,2784.61,83,5.8,2461646,172069.06,2578,2481,0.5,0,0,0
1303,南亞         ,20200211,63,4.41,39900,2793,-892,-62.44,2460909,172263.63,727,1684,0.5,63,0,0
1303,南亞         ,20200212,39,2.72,39939,2787.74,-975,-68.06,2460054,171711.77,1552,2785,0.5,39,0,0
1303,南亞         ,20200213,59,4.15,39998,2815.86,-273,-19.22,2459996,173183.72,1438,1779,0.5,59,0,0
1303,南亞         ,20200214,40,2.82,40038,2818.68,-215,-15.14,2460209,173198.71,1314,1568,0.5,40,0,0
1303,南亞         ,20200217,1,0.07,40039,2806.73,-177,-12.41,2460017,172447.19,652,829,0.5,1,0,0
1303,南亞         ,20200218,90,6.31,40129,2813.04,-1221,-85.59,2460426,172475.86,1389,2658,0.51,90,0,0
1303,南亞         ,20200219,41,2.9,40170,2844.04,1776,125.74,2462357,174334.88,3118,1449,0.51,41,0,0
1303,南亞         ,20200220,8,0.56,40178,2812.46,-1744,-122.08,2460187,172213.09,1107,2894,0.51,8,0,0
1303,南亞         ,20200221,56,3.91,40234,2808.33,-1031,-71.96,2458780,171622.84,1875,3008,0.51,56,0,0
1303,南亞         ,20200224,281,19.36,40515,2791.48,-2543,-175.21,2456264,169236.59,1790,4593,0.51,281,0,0
1303,南亞         ,20200225,44,3.01,40559,2778.29,-1952,-133.71,2450743,167875.9,2299,4295,0.51,49,5,0
1303,南亞         ,20200226,204,13.81,40763,2759.66,-5066,-342.97,2445663,165571.39,2610,7883,0.51,204,0,0
1303,南亞         ,20200227,237,16.14,41000,2792.1,-999,-68.03,2446970,166638.66,4044,5248,0.52,237,0,0
1303,南亞         ,20200302,139,9.41,41139,2785.11,-1018,-68.92,2446354,165618.17,5398,6722,0.52,142,3,0
1303,南亞         ,20200303,-27,-1.83,41112,2783.28,-1341,-90.79,2442514,165358.2,2825,4481,0.52,57,84,0
1303,南亞         ,20200304,112,7.71,41224,2836.21,2117,145.65,2444140,168156.83,3859,1961,0.52,112,0,0
1303,南亞         ,20200305,0,0,41224,2873.31,2193,152.85,2446315,170508.16,3386,1664,0.52,0,0,0
1303,南亞         ,20200306,7,0.48,41231,2811.95,-3562,-242.93,2440363,166432.76,2672,5899,0.52,7,0,0
1303,南亞         ,20200309,544,35.9,41775,2757.15,-6861,-452.83,2433192,160590.67,2604,9900,0.53,544,0,0
1303,南亞         ,20200310,36,2.38,41811,2767.89,-96,-6.36,2434951,161193.76,5067,5204,0.53,36,0,0
1303,南亞         ,20200311,7,0.46,41818,2772.53,-1784,-118.28,2433091,161313.93,3773,5014,0.53,7,0,0
1303,南亞         ,20200312,61,3.89,41879,2671.88,-3523,-224.77,2428698,154950.93,4542,7987,0.53,61,0,0
1303,南亞         ,20200313,78,4.79,41957,2576.16,-5461,-335.31,2422450,148738.43,7770,13334,0.53,78,0,0
1303,南亞         ,20200316,11,0.65,41968,2467.72,-4910,-288.71,2418716,142220.5,4075,8406,0.53,29,18,0
1303,南亞         ,20200317,170,9.52,42138,2359.73,151,8.46,2418101,135413.66,11088,11128,0.53,170,0,0
1303,南亞         ,20200318,231,12.1,42369,2220.14,-1898,-99.46,2417979,126702.1,9284,9418,0.53,231,0,0
1303,南亞         ,20200319,75,3.56,42444,2007.6,-1925,-91.05,2414666,114213.7,9547,11479,0.54,99,24,0
1303,南亞         ,20200320,286,14.32,42730,2140.77,-8238,-412.72,2405291,120505.08,8609,16998,0.54,322,36,0
1303,南亞         ,20200323,-9,-0.44,42721,2078.38,1578,76.77,2407077,117104.3,8946,7507,0.54,32,41,0
1303,南亞         ,20200324,0,0,42721,2208.68,1921,99.32,2409155,124553.31,6611,4709,0.54,0,0,0
1303,南亞         ,20200325,0,0,42721,2379.56,1234,68.73,2407377,134090.9,4292,2929,0.54,0,0,0
1303,南亞         ,20200326,20,1.09,42741,2376.4,313,17.4,2407947,133881.85,3383,3073,0.54,43,23,0
1303,南亞         ,20200327,7,0.39,42748,2376.79,-199,-11.06,2407401,133851.5,2483,2872,0.54,8,1,0
1303,南亞         ,20200330,0,0,42748,2376.79,1281,71.22,2408272,133899.92,6401,5011,0.54,0,0,0
1303,南亞         ,20200331,97,5.31,52502,2871.86,-2116,-115.75,2420188,132384.28,6167,8248,0.66,112,15,0
1303,南亞         ,20200401,9,0.48,52511,2819.84,-163,-8.75,2420292,129969.68,4188,4336,0.66,9,0,0
1303,南亞         ,20200406,28,1.55,52539,2905.41,385,21.29,2416880,133653.46,5389,5025,0.66,28,0,0
1303,南亞         ,20200407,44,2.48,52583,2960.42,406,22.86,2415698,136003.8,3234,2863,0.66,44,0,0
1303,南亞         ,20200408,10,0.58,52593,3055.65,1120,65.07,2416828,140417.71,3958,2586,0.66,10,0,0
1303,南亞         ,20200409,5,0.29,52598,3055.94,-1744,-101.33,2415269,140327.13,1223,2911,0.66,5,0,0
1303,南亞         ,20200410,-64,-3.74,52534,3067.99,-98,-5.72,2415095,141041.55,1713,1725,0.66,15,79,0
1303,南亞         ,20200413,44,2.57,52578,3039.01,-809,-46.76,2414646,139566.54,1013,1631,0.66,60,16,0
1303,南亞         ,20200414,120,7.21,52698,3167.15,4350,261.44,2419423,145407.32,7635,3440,0.66,120,0,0
1303,南亞         ,20200415,0,0,52698,3204.04,152,9.24,2418456,147042.12,3229,3005,0.66,0,0,0
1303,南亞         ,20200416,-3,-0.18,52695,3156.43,-2102,-125.91,2416751,144763.38,4253,6254,0.66,5,8,0
1303,南亞         ,20200417,110,6.61,52805,3173.58,154,9.26,2416145,145210.31,3527,3499,0.67,111,1,0
1303,南亞         ,20200420,10,0.6,52815,3153.06,-572,-34.15,2415754,144220.51,3124,3668,0.67,10,0,0
1303,南亞         ,20200421,-6,-0.34,52809,3020.67,-4654,-266.21,2419219,138379.33,2374,6665,0.67,0,6,0
1303,南亞         ,20200422,72,4.1,52881,3008.93,515,29.3,2419426,137665.34,2504,2058,0.67,76,4,0
1303,南亞         ,20200423,103,5.92,52984,3046.58,228,13.11,2419795,139138.21,3074,2890,0.67,109,6,0
1303,南亞         ,20200424,44,2.51,53028,3022.6,-568,-32.38,2419243,137896.85,1960,2560,0.67,50,6,0
1303,南亞         ,20200427,209,12.46,53237,3172.93,5664,337.57,2425606,144566.12,7271,1868,0.67,209,0,0
1303,南亞         ,20200428,1008,60.78,54245,3270.97,252,15.2,2424970,146225.69,1804,2530,0.68,1008,0,0.01
1303,南亞         ,20200429,798,49.88,55043,3440.19,3631,226.94,2428986,151811.63,5101,2052,0.69,798,0,0.01
1303,南亞         ,20200430,1595,105.59,56638,3749.44,3358,222.3,2432483,161030.37,6386,4617,0.71,1595,0,0.01
1303,南亞         ,20200504,345,21.91,56983,3618.42,-7549,-479.36,2423942,153920.32,2809,10687,0.72,345,0,0
1303,南亞         ,20200505,-33,-2.07,56950,3633.41,-1162,-74.14,2424040,154653.75,1094,2216,0.72,108,141,0
1303,南亞         ,20200506,37,2.33,56987,3590.18,-1479,-93.18,2422942,152645.35,2721,3981,0.72,37,0,0
1303,南亞         ,20200507,-6,-0.38,56981,3589.8,263,16.57,2423566,152684.66,2459,2238,0.72,40,46,0
1303,南亞         ,20200508,45,2.88,57026,3649.66,419,26.82,2423952,155132.93,2248,1918,0.72,45,0,0
1303,南亞         ,20200511,16,1.03,57042,3684.91,766,49.48,2423983,156589.3,1990,1227,0.72,16,0,0
1303,南亞         ,20200512,0,0,57042,3622.17,-3521,-223.58,2420650,153711.28,2892,6391,0.72,0,0,0
1303,南亞         ,20200513,41,2.62,57083,3653.31,124,7.94,2420608,154918.91,2049,1950,0.72,41,0,0
1303,南亞         ,20200514,57,3.57,57140,3582.68,-1778,-111.48,2418903,151665.22,1492,3319,0.72,57,0,0
1303,南亞         ,20200515,280,17.56,57420,3600.23,-482,-30.22,2418356,151630.92,1713,2506,0.72,280,0,0
1303,南亞         ,20200518,4,0.25,57424,3594.74,-259,-16.21,2418052,151370.06,2015,2386,0.72,4,0,0
1303,南亞         ,20200519,62,3.94,57486,3656.11,1198,76.19,2418084,153790.14,4364,3287,0.72,62,0,0
1303,南亞         ,20200520,15,0.96,57501,3674.31,1255,80.19,2419561,154609.95,2681,1696,0.73,15,0,0
1303,南亞         ,20200521,0,0,57501,3674.31,332,21.21,2419680,154617.55,1771,1441,0.73,0,0,0
1303,南亞         ,20200522,4,0.25,57505,3582.56,-4019,-250.38,2416762,150564.27,1999,6029,0.73,4,0,0
1303,南亞         ,20200525,24,1.48,57529,3572.55,-316,-19.62,2416446,150061.3,2024,2411,0.73,24,0,0
1303,南亞         ,20200526,182,11.52,57711,3653.11,3444,218.01,2419781,153172.14,5086,1785,0.73,200,18,0
1303,南亞         ,20200527,13,0.82,57724,3642.38,-467,-29.47,2419430,152666.03,2382,2855,0.73,13,0,0
1303,南亞         ,20200528,0,0,57724,3607.75,-982,-61.38,2418781,151173.81,2922,3824,0.73,0,0,0
1303,南亞         ,20200529,0,0,57724,3630.84,1529,96.17,2419469,152184.6,13771,12239,0.73,0,0,0
1303,南亞         ,20200601,-16,-1.01,57708,3647.15,3111,196.62,2422579,153106.99,4565,1526,0.73,0,16,0
1303,南亞         ,20200602,0,0,57708,3681.77,1974,125.94,2424553,154686.48,2737,787,0.73,0,0,0
1303,南亞         ,20200603,-33,-2.15,57675,3748.88,5889,382.79,2430481,157981.27,7688,2733,0.73,0,33,0
1303,南亞         ,20200604,-527,-34.26,57148,3714.62,1156,75.14,2431809,158067.58,3444,1770,0.72,0,527,0
1303,南亞         ,20200605,-779,-50.87,56369,3680.9,918,59.95,2430229,158693.95,3135,1409,0.71,0,779,0
1303,南亞         ,20200608,-564,-37.51,55805,3711.03,4178,277.84,2434894,161920.45,5776,1038,0.7,0,564,0
1303,南亞         ,20200609,-15,-1,55790,3737.93,1274,85.36,2434055,163081.69,3365,2072,0.7,2,17,0
1303,南亞         ,20200610,-26,-1.75,55764,3758.49,2397,161.56,2435328,164141.11,5545,3124,0.7,0,26,0
1303,南亞         ,20200611,-151,-9.97,55613,3670.46,-109,-7.19,2434971,160708.09,3262,3145,0.7,0,151,0
1303,南亞         ,20200612,-31,-2.02,55582,3629.5,306,19.98,2432135,158818.42,3139,2804,0.7,0,31,0
1303,南亞         ,20200615,-4,-0.26,55578,3562.55,-2634,-168.84,2429162,155709.28,3707,6139,0.7,0,4,0
1303,南亞         ,20200616,-133,-8.62,55445,3598.38,383,24.86,2427887,157569.87,3714,3203,0.7,0,133,0
1303,南亞         ,20200617,-230,-14.93,55215,3583.45,-181,-11.75,2426303,157467.06,3373,2841,0.7,0,230,0
1303,南亞         ,20200618,-391,-25.38,54824,3558.08,-325,-21.09,2425978,157445.97,3445,3392,0.69,0,391,0
1303,南亞         ,20200619,-4483,-286.02,50341,3211.76,-4110,-262.22,2422808,154575.15,10865,10532,0.63,13,4496,0.03
1303,南亞         ,20200622,-27,-1.74,50314,3240.22,997,64.21,2423381,156065.74,1999,977,0.63,0,27,0
1303,南亞         ,20200623,147,9.56,50461,3279.97,2226,144.69,2426407,157716.45,3970,1881,0.64,151,4,0
1303,南亞         ,20200624,143,9.25,50604,3274.08,222,14.36,2424580,156870.33,2781,2671,0.64,168,25,0
1303,南亞         ,20200629,8,0.51,50612,3239.17,-1211,-77.5,2422804,155059.46,2360,3623,0.64,8,0,0
1303,南亞         ,20200630,0,0,57823,3735.37,2718,175.58,2431988,157106.42,4710,1955,0.73,0,0,0
1303,南亞         ,20200701,-24,-1.56,57799,3768.49,271,17.67,2432419,158593.72,1682,1322,0.73,0,24,0
1303,南亞         ,20200702,-16,-1.05,57783,3779.01,-197,-12.88,2432115,159060.32,1925,2145,0.73,0,16,0
1303,南亞         ,20200703,-46,-3.03,57737,3799.09,420,27.64,2432518,160059.68,1647,1169,0.73,0,46,0
1303,南亞         ,20200706,-62,-4.15,57675,3864.23,5566,372.92,2438094,163352.3,6163,1092,0.73,0,62,0
1303,南亞         ,20200707,-40,-2.59,57635,3734.75,200,12.96,2430433,157492.06,3872,3222,0.73,0,40,0
1303,南亞         ,20200708,-32,-2.07,57603,3732.67,377,24.43,2432506,157626.39,3808,3577,0.73,0,32,0
1303,南亞         ,20200709,-32,-2.06,57571,3701.82,-558,-35.88,2432917,156436.56,3479,4003,0.73,0,32,0
1303,南亞         ,20200710,-50,-3.17,57521,3641.08,-2037,-128.94,2429254,153771.78,1808,3739,0.73,0,50,0
1303,南亞         ,20200713,211,13.46,57732,3683.3,939,59.91,2432069,155166,3902,2222,0.73,230,19,0
1303,南亞         ,20200714,4,0.25,57736,3666.24,-133,-8.45,2432410,154458.04,3120,2970,0.73,383,379,0
1303,南亞         ,20200715,357,22.88,58093,3723.76,1169,74.93,2437018,156212.85,4171,3023,0.73,460,103,0
1303,南亞         ,20200716,1168,75.45,59261,3828.26,1184,76.49,2440153,157633.88,3013,2468,0.75,1182,14,0.01
1303,南亞         ,20200717,1314,84.62,60575,3901.03,647,41.67,2441790,157251.28,1238,1928,0.76,1382,68,0.01
1303,南亞         ,20200720,561,35.62,61136,3882.14,-1071,-68.01,2443609,155169.17,1744,3412,0.77,617,56,0
1303,南亞         ,20200721,514,32.9,61650,3945.6,3455,221.12,2446601,156582.46,5343,2402,0.78,623,109,0
1303,南亞         ,20200722,820,52.81,62470,4023.07,1133,72.97,2447246,157602.64,2598,2238,0.79,874,54,0.01
1303,南亞         ,20200723,291,18.48,62761,3985.32,-416,-26.42,2447843,155438.03,1815,2380,0.79,398,107,0
1303,南亞         ,20200724,413,26.06,63174,3986.28,-1338,-84.43,2446756,154390.3,1592,3087,0.8,483,70,0
1303,南亞         ,20200727,387,24.18,63561,3972.56,-1216,-76,2445665,152854.06,1568,3102,0.8,444,57,0
1303,南亞         ,20200728,390,23.95,63951,3926.59,-1758,-107.94,2444164,150071.67,3385,5482,0.81,447,57,0
1303,南亞         ,20200729,147,8.98,64098,3916.39,-915,-55.91,2444128,149336.22,1784,2032,0.81,161,14,0
1303,南亞         ,20200730,414,25.46,64512,3967.49,-37,-2.28,2444344,150327.16,2619,3072,0.81,446,32,0
1303,南亞         ,20200731,90,5.5,64602,3947.18,-698,-42.65,2443441,149294.25,6285,7077,0.81,90,0,0
1303,南亞         ,20200803,24,1.44,64626,3890.49,-3505,-211,2440023,146889.38,3100,6631,0.81,24,0,0
1303,南亞         ,20200804,681,41.13,65307,3944.54,234,14.13,2440236,147390.25,2449,2898,0.82,681,0,0
1303,南亞         ,20200805,783,47.53,66090,4011.66,302,18.33,2440576,148142.96,1610,2057,0.83,790,7,0.01
1303,南亞         ,20200806,182,11.19,66272,4075.73,1348,82.9,2441903,150177.03,2587,1510,0.84,191,9,0
1303,南亞         ,20200807,-1030,-62.62,65242,3966.71,-1641,-99.77,2441168,148423.01,1828,2447,0.82,0,1030,0.01
1303,南亞         ,20200810,-147,-9.29,65095,4114,1947,123.05,2442945,154394.12,3043,972,0.82,23,170,0
1303,南亞         ,20200811,393,24.68,65488,4112.65,-1204,-75.61,2441581,153331.29,1278,2839,0.83,393,0,0
1303,南亞         ,20200812,114,7.18,65602,4132.93,-847,-53.36,2441376,153806.69,1546,2240,0.83,114,0,0
1303,南亞         ,20200813,176,11.19,65778,4183.48,486,30.91,2441962,155308.78,2346,1995,0.83,176,0,0
1303,南亞         ,20200814,0,0,65778,4163.75,345,21.84,2442750,154626.08,1003,675,0.83,0,0,0
1303,南亞         ,20200817,-20,-1.28,65758,4201.94,716,45.75,2443393,156132.81,1482,858,0.83,5,25,0
1303,南亞         ,20200818,5,0.32,65763,4195.68,515,32.86,2444814,155979.13,2583,2054,0.83,5,0,0
1303,南亞         ,20200819,-261,-16.36,65502,4106.98,-1085,-68.03,2445415,153327.52,1992,2905,0.83,7,268,0
1303,南亞         ,20200820,27,1.64,65529,3984.16,-3492,-212.31,2443440,148561.15,1966,5386,0.83,27,0,0
1303,南亞         ,20200821,663,41.3,66192,4123.76,857,53.39,2445716,152368.11,1945,1732,0.83,675,12,0
1303,南亞         ,20200824,309,19.1,66501,4109.76,79,4.88,2445893,151156.19,1185,1374,0.84,309,0,0
1303,南亞         ,20200825,0,0,66501,4103.11,683,42.14,2446352,150939.92,3163,2550,0.84,0,0,0
1303,南亞         ,20200826,-253,-15.68,66248,4107.38,-681,-42.22,2443611,151503.88,2493,2864,0.84,11,264,0
1303,南亞         ,20200827,0,0,66248,4080.88,-185,-11.4,2443458,150517.01,1559,1735,0.84,0,0,0
1303,南亞         ,20200828,5,0.31,66253,4094.44,329,20.33,2442817,150966.09,2612,2268,0.84,5,0,0
1303,南亞         ,20200831,10,0.62,66263,4075.17,-976,-60.02,2441999,150182.94,4627,5616,0.84,10,0,0
1303,南亞         ,20200901,364,22.12,66627,4050.92,-2064,-125.49,2439943,148348.53,4207,6665,0.84,378,14,0
1303,南亞         ,20200902,155,9.42,66782,4060.35,-2450,-148.96,2436719,148152.52,1571,4113,0.84,155,0,0
1303,南亞         ,20200903,-2,-0.13,66780,4066.9,736,44.82,2437352,148434.74,3850,3185,0.84,5,7,0
1303,南亞         ,20200904,215,13.01,66995,4053.2,-194,-11.74,2437048,147441.4,2253,2611,0.84,215,0,0
1303,南亞         ,20200907,2,0.12,66997,4093.52,970,59.27,2437690,148942.86,2974,2020,0.84,2,0,0
1303,南亞         ,20200908,50,3.06,67047,4096.57,-74,-4.52,2438737,149006.83,1733,1855,0.85,50,0,0
1303,南亞         ,20200909,236,14.4,67283,4104.26,-1512,-92.23,2437057,148660.48,1692,3340,0.85,236,0,0
1303,南亞         ,20200910,1,0.06,67284,4104.32,-100,-6.1,2435278,148551.96,1375,1439,0.85,1,0,0
1303,南亞         ,20200911,9,0.55,67293,4091.41,-931,-56.6,2434212,148000.09,1610,2578,0.85,9,0,0
1303,南亞         ,20200914,0,0,67293,4104.87,97,5.92,2434861,148526.52,1910,1827,0.85,0,0,0
1303,南亞         ,20200915,-16,-0.99,67277,4117.35,1802,110.28,2436690,149125.43,3934,2122,0.85,0,16,0
1303,南亞         ,20200916,125,7.64,67402,4118.26,631,38.55,2436764,148886.28,2658,2052,0.85,152,27,0
1303,南亞         ,20200917,-28,-1.7,67374,4103.08,-1091,-66.44,2436175,148363.06,2047,3056,0.85,4,32,0
1303,南亞         ,20200918,124,7.6,67498,4137.63,756,46.34,2437047,149390.98,10146,9537,0.85,280,156,0
1303,南亞         ,20200921,-3,-0.18,67495,4150.94,125,7.69,2436720,149858.28,3549,3265,0.85,5,8,0
1303,南亞         ,20200922,-27,-1.63,67468,4068.32,-2311,-139.35,2434416,146795.28,2256,4380,0.85,2,29,0
1303,南亞         ,20200923,45,2.69,67513,4050.78,-2925,-175.5,2432007,145920.42,1386,3647,0.85,231,186,0
1303,南亞         ,20200924,222,12.88,67735,3928.63,-9191,-533.08,2422868,140526.34,1645,11043,0.85,222,0,0
1303,南亞         ,20200925,283,16.47,68018,3958.65,-635,-36.96,2422223,140973.38,2046,2965,0.86,283,0,0
1303,南亞         ,20200928,0,0,68018,4040.27,853,50.67,2423759,143971.28,2411,1610,0.86,0,0,0
1303,南亞         ,20200929,80,4.77,68098,4058.64,794,47.32,2422252,144366.22,4037,3338,0.86,80,0,0
1303,南亞         ,20200930,0,0,58551,3483.78,367,21.84,2413323,143592.72,3107,2747,0.74,0,0,0
1303,南亞         ,20201005,0,0,58551,3495.49,1314,78.45,2415608,144211.8,2505,1185,0.74,0,0,0
1303,南亞         ,20201006,11,0.67,58562,3566.43,2830,172.35,2418470,147284.82,3695,862,0.74,11,0,0
1303,南亞         ,20201007,-5,-0.3,58557,3536.84,146,8.82,2418656,146086.82,2122,2000,0.74,0,5,0
1303,南亞         ,20201008,-8,-0.49,58549,3553.92,325,19.73,2418201,146784.8,1189,850,0.74,0,8,0
1303,南亞         ,20201012,-346,-21.18,58203,3562.02,1191,72.89,2419545,148076.15,3693,2155,0.73,0,346,0
1303,南亞         ,20201013,-4,-0.24,58199,3538.5,-324,-19.7,2419599,147111.62,1886,2172,0.73,0,4,0
1303,南亞         ,20201014,0,0,58199,3521.04,90,5.45,2420392,146433.72,5525,5230,0.73,0,0,0
1303,南亞         ,20201015,0,0,58199,3462.84,-2438,-145.06,2417329,143831.08,3993,6357,0.73,0,0,0
1303,南亞         ,20201016,7,0.41,58206,3445.8,-597,-35.34,2416708,143069.11,3905,4488,0.73,19,12,0
1303,南亞         ,20201019,0,0,58206,3434.15,-931,-54.93,2416367,142565.65,3347,4294,0.73,0,0,0
1303,南亞         ,20201020,0,0,58206,3457.44,-229,-13.6,2416239,143524.6,3839,4050,0.73,0,0,0
1303,南亞         ,20201021,-2818,-165.13,55388,3245.74,-3743,-219.34,2413274,141417.86,4251,4457,0.7,0,2818,0.02
1303,南亞         ,20201022,-1539,-93.11,53849,3257.86,-2692,-162.87,2411956,145923.34,16627,17779,0.68,0,1539,0.01
1303,南亞         ,20201023,0,0,53849,3204.02,-1050,-62.48,2411091,143459.91,4025,5087,0.68,0,0,0
1303,南亞         ,20201026,-24,-1.44,53825,3229.5,920,55.2,2412477,144748.62,3584,1798,0.68,0,24,0
1303,南亞         ,20201027,0,0,53825,3234.88,1863,111.97,2413727,145064.99,5741,3953,0.68,0,0,0
1303,南亞         ,20201028,-17,-1.02,53808,3217.72,-705,-42.16,2413514,144328.14,2535,2653,0.68,0,17,0
1303,南亞         ,20201029,0,0,53808,3174.67,-2561,-151.1,2411025,142250.48,1863,4455,0.68,0,0,0
1303,南亞         ,20201030,0,0,53808,3158.53,-1493,-87.64,2409061,141411.88,4182,5479,0.68,0,0,0
1303,南亞         ,20201102,0,0,53808,3212.34,1367,81.61,2411136,143944.82,2695,1365,0.68,0,0,0
1303,南亞         ,20201103,1,0.06,53809,3271.59,4547,276.46,2415887,146885.93,6376,1856,0.68,1,0,0
1303,南亞         ,20201104,1,0.06,53810,3282.41,975,59.48,2416861,147428.52,2875,1895,0.68,1,0,0
1303,南亞         ,20201105,8,0.49,53818,3309.81,2691,165.5,2419405,148793.41,3675,991,0.68,8,0,0
1303,南亞         ,20201106,-4,-0.25,53814,3320.32,2528,155.98,2421950,149434.32,3871,1347,0.68,0,4,0
1303,南亞         ,20201109,-136,-8.45,53678,3333.4,2329,144.63,2424294,150548.66,3802,1374,0.68,0,136,0
1303,南亞         ,20201110,0,0,53678,3381.71,3772,237.64,2428255,152980.07,4770,1095,0.68,0,0,0
1303,南亞         ,20201111,-49,-3.2,53629,3501.97,7963,519.98,2436262,159087.91,10284,2877,0.68,228,277,0
1303,南亞         ,20201112,-390,-24.92,53239,3401.97,-1332,-85.11,2436358,155683.28,4716,5621,0.67,0,390,0
1303,南亞         ,20201113,-156,-10,53083,3402.62,991,63.52,2437349,156234.07,3261,2125,0.67,0,156,0
1303,南亞         ,20201116,12,0.77,53095,3424.63,3075,198.34,2440166,157390.71,4856,1792,0.67,12,0,0
1303,南亞         ,20201117,-517,-33.62,52578,3417.57,1057,68.71,2441269,158682.48,5407,3857,0.66,0,517,0
1303,南亞         ,20201118,-382,-25.02,52196,3418.84,1386,90.78,2444141,160091.24,6672,4920,0.66,0,382,0
1303,南亞         ,20201119,-249,-16.26,51947,3392.14,11,0.72,2444125,159601.36,3425,3182,0.66,1,250,0
1303,南亞         ,20201120,-302,-19.84,51645,3393.08,2246,147.56,2446771,160752.85,4838,2291,0.65,42,344,0
1303,南亞         ,20201123,-102,-6.75,51543,3412.15,2029,134.32,2449008,162124.33,4372,2313,0.65,70,172,0
1303,南亞         ,20201124,-148,-9.71,51395,3371.51,-548,-35.95,2448295,160608.15,2043,2434,0.65,8,156,0
1303,南亞         ,20201125,3,0.2,51398,3366.57,-405,-26.53,2447923,160338.96,2966,3394,0.65,3,0,0
1303,南亞         ,20201126,-120,-7.9,51278,3374.09,69,4.54,2447994,161078.01,3122,2985,0.65,17,137,0
1303,南亞         ,20201127,4,0.26,51282,3364.1,-506,-33.19,2448504,160621.86,6529,5056,0.65,4,0,0
1303,南亞         ,20201130,-271,-17.4,51011,3274.91,-3672,-235.74,2444943,156965.34,17655,21075,0.64,12,283,0
1303,南亞         ,20201201,-541,-35.71,50470,3331.02,-364,-24.02,2444356,161327.5,2681,2443,0.64,43,584,0
1303,南亞         ,20201202,-9,-0.59,50461,3310.24,-704,-46.18,2444561,160363.2,6297,6059,0.64,1,10,0
1303,南亞         ,20201203,-303,-20.18,50158,3340.52,-2901,-193.21,2442438,162666.37,5152,6857,0.63,0,303,0
1303,南亞         ,20201204,156,10.56,50314,3406.26,2806,189.97,2445695,165573.55,6335,3547,0.63,156,0,0
1303,南亞         ,20201207,0,0,50314,3396.2,-1524,-102.87,2444106,164977.16,2853,4351,0.63,0,0,0
1303,南亞         ,20201208,-271,-18.21,50043,3362.89,-1454,-97.71,2442973,164167.79,1639,2761,0.63,4,275,0
1303,南亞         ,20201209,-553,-37.11,49490,3320.78,235,15.77,2443263,163942.95,2894,2128,0.62,13,566,0
1303,南亞         ,20201210,-202,-13.7,49288,3341.73,-78,-5.29,2442899,165628.55,2496,2265,0.62,19,221,0
1303,南亞         ,20201211,-60,-4.09,49228,3362.27,415,28.34,2443344,166880.4,2611,2094,0.62,8,68,0
1303,南亞         ,20201214,-230,-15.61,48998,3322.06,-1062,-72,2442155,165578.11,1862,2285,0.62,8,238,0
1303,南亞         ,20201215,23,1.57,49021,3294.21,-2031,-136.48,2439894,163960.88,2023,4044,0.62,23,0,0
1303,南亞         ,20201216,0,0,49021,3367.74,4291,294.79,2444204,167916.81,5824,1515,0.62,0,0,0
1303,南亞         ,20201217,148,10.16,49169,3372.99,-298,-20.44,2443775,167642.97,2373,2606,0.62,159,11,0
1303,南亞         ,20201218,-74,-4.99,49095,3313.91,-2384,-160.92,2441410,164795.18,4604,6871,0.62,310,384,0
1303,南亞         ,20201221,-7,-0.49,49088,3406.71,3647,253.1,2445892,169744.9,4526,960,0.62,10,17,0
1303,南亞         ,20201222,75,5.11,49163,3372.58,-630,-43.22,2445189,167739.97,2173,2752,0.62,80,5,0
1303,南亞         ,20201223,0,0,49163,3348,-855,-58.23,2444507,166470.93,752,1410,0.62,0,0,0
1303,南亞         ,20201224,-94,-6.54,49069,3395.57,133,9.2,2444736,169175.73,1049,766,0.62,12,106,0
1303,南亞         ,20201225,62,4.3,49131,3409.69,238,16.52,2445101,169690.01,1056,753,0.62,62,0,0
1303,南亞         ,20201228,-1,-0.07,49130,3468.58,2037,143.81,2447286,172778.39,2747,561,0.62,0,1,0
1303,南亞         ,20201229,56,3.92,49186,3462.69,62,4.36,2447058,172272.88,894,703,0.62,239,183,0
1303,南亞         ,20201230,21,1.52,49207,3567.51,8547,619.66,2455689,178037.45,8954,1066,0.62,21,0,0
1303,南亞         ,20201231,-335,-24.09,48032,3453.5,-312,-22.43,2454246,176460.29,3178,2886,0.61,0,335,0
1303,南亞         ,20210104,-763,-54.51,47269,3375.01,789,56.33,2454956,175283.86,4908,3540,0.6,8,771,0
1303,南亞         ,20210105,-193,-13.71,47076,3342.4,-520,-36.92,2454435,174264.89,1799,2201,0.59,26,219,0
1303,南亞         ,20210106,-184,-13.01,46892,3315.26,-979,-69.22,2453899,173490.66,2945,3006,0.59,0,184,0
1303,南亞         ,20210107,22,1.59,46914,3354.35,2217,158.52,2456098,175611.01,3668,1624,0.59,22,0,0
1303,南亞         ,20210108,-877,-63.76,46037,3346.89,4507,327.66,2460794,178899.72,7405,2502,0.58,23,900,0.01
1303,南亞         ,20210111,-59,-4.37,45978,3420.76,5688,423.19,2466392,183499.56,7743,2399,0.58,39,98,0
1303,南亞         ,20210112,22,1.62,46000,3385.6,1267,93.25,2467669,181620.44,4035,2119,0.58,22,0,0
1303,南亞         ,20210113,232,17.17,46232,3421.17,3662,270.99,2471268,182873.83,6870,3813,0.58,232,0,0
1303,南亞         ,20210114,-47,-3.49,46185,3426.93,2942,218.3,2474423,183602.19,5308,2139,0.58,60,107,0
1303,南亞         ,20210115,61,4.41,46246,3343.59,-1277,-92.33,2472553,178765.58,2058,3378,0.58,61,0,0
1303,南亞         ,20210118,40,2.83,46286,3309.45,-474,-33.89,2471815,176734.77,2650,3089,0.58,40,0,0
1303,南亞         ,20210119,-145,-10.4,46141,3308.31,-188,-13.48,2471548,177209.99,1856,1897,0.58,13,158,0
1303,南亞         ,20210120,3,0.21,46144,3197.78,-3795,-262.99,2466949,170959.57,5113,8745,0.58,10,7,0
1303,南亞         ,20210121,-167,-11.57,45977,3186.21,-435,-30.15,2467686,171010.64,2929,3191,0.58,105,272,0
1303,南亞         ,20210122,25,1.73,46002,3183.34,-215,-14.88,2467408,170744.63,5740,6147,0.58,25,0,0
1303,南亞         ,20210125,-15,-1.06,45987,3232.89,1459,102.57,2468544,173538.64,4122,2671,0.58,103,118,0
1303,南亞         ,20210126,34,2.36,46021,3198.46,-1045,-72.63,2467607,171498.69,4711,5676,0.58,35,1,0
1303,南亞         ,20210127,10,0.69,46031,3180.74,-1143,-78.98,2466251,170417.94,4172,5308,0.58,10,0,0
1303,南亞         ,20210128,12,0.81,46043,3117.11,-2722,-184.28,2463774,166797.5,4772,7394,0.58,12,0,0
1303,南亞         ,20210129,4,0.26,46047,3020.68,-5281,-346.43,2458501,161277.67,4876,10124,0.58,4,0,0
1303,南亞         ,20210201,7,0.47,46054,3071.8,-108,-7.2,2455237,163764.31,2516,2732,0.58,7,0,0
1303,南亞         ,20210202,8,0.55,46062,3169.07,-447,-30.75,2457467,169073.73,3174,3910,0.58,8,0,0
1303,南亞         ,20210203,0,0,46062,3169.07,-2025,-139.32,2455447,168934.75,4029,6601,0.58,0,0,0
1303,南亞         ,20210204,-93,-6.41,45969,3167.26,-1358,-93.57,2454144,169090.52,2730,3831,0.58,14,107,0
1303,南亞         ,20210205,4,0.28,45973,3149.15,-1308,-89.6,2452988,168029.68,2286,3698,0.58,11,7,0
1303,南亞         ,20210217,20,1.4,45993,3219.51,-3207,-224.49,2449869,171490.83,5635,8748,0.58,21,1,0
1303,南亞         ,20210218,19,1.34,46012,3253.05,91,6.43,2450084,173220.94,3692,3506,0.58,48,29,0
1303,南亞         ,20210219,75,5.27,46087,3235.31,-5426,-380.91,2444564,171608.39,1977,7214,0.58,75,0,0
1303,南亞         ,20210222,15,1.07,46102,3300.9,-421,-30.14,2443968,174988.11,2682,3160,0.58,15,0,0
1303,南亞         ,20210223,57,4.21,46159,3406.53,3401,250.99,2447452,180621.96,6210,2990,0.58,57,0,0
1303,南亞         ,20210224,27,1.99,46186,3408.53,-304,-22.44,2447167,180600.92,5509,5729,0.58,27,0,0
1303,南亞         ,20210225,1129,84.68,47315,3548.63,4730,354.75,2451733,183879.98,7589,4010,0.6,1130,1,0.01
1303,南亞         ,20210226,394,28.64,47709,3468.44,-9307,-676.62,2441542,177500.1,7729,17361,0.6,394,0,0
1303,南亞         ,20210302,253,18.67,47962,3539.6,1023,75.5,2441785,180203.73,4675,3944,0.6,253,0,0
1303,南亞         ,20210303,374,27.98,48336,3615.53,4619,345.5,2446372,182988.63,9763,6229,0.61,374,0,0
1303,南亞         ,20210304,71,5.21,48407,3553.07,-5181,-380.29,2440958,179166.32,5534,10675,0.61,71,0,0
1303,南亞         ,20210305,242,17.64,48649,3546.51,-1348,-98.27,2439396,177831.97,3624,5266,0.61,242,0,0
1303,南亞         ,20210308,-108,-7.94,48541,3567.76,-1353,-99.45,2438044,179196.23,2337,3691,0.61,146,254,0
1303,南亞         ,20210309,213,15.68,48754,3588.29,662,48.72,2438639,179483.83,4816,4324,0.61,213,0,0
1303,南亞         ,20210310,2141,159.72,50895,3796.77,2305,171.95,2441649,182147.02,3921,3776,0.64,2144,3,0.01
1303,南亞         ,20210311,1503,115.28,52398,4018.93,11608,890.33,2452890,188136.66,8070,1933,0.66,1503,0,0.01
1303,南亞         ,20210312,580,44.78,52978,4089.9,1751,135.18,2454641,189498.29,2628,2473,0.67,580,0,0
1303,南亞         ,20210315,105,8.06,53083,4076.77,3898,299.37,2458560,188817.41,7322,4817,0.67,105,0,0
1303,南亞         ,20210316,30,2.32,53113,4105.63,3904,301.78,2462463,190348.39,5705,3474,0.67,30,0,0
1303,南亞         ,20210317,-212,-16.2,52901,4041.64,-2151,-164.34,2459751,187924.98,2569,5134,0.67,0,212,0
1303,南亞         ,20210318,-478,-36.61,52423,4015.6,594,45.5,2460373,188464.57,4736,2925,0.66,59,537,0
1303,南亞         ,20210319,-124,-9.22,52299,3896.28,-6021,-448.56,2454620,182869.19,9964,16744,0.66,135,259,0
1303,南亞         ,20210322,21,1.6,52320,3997.25,2139,163.42,2456660,187688.82,5217,2702,0.66,21,0,0
1303,南亞         ,20210323,11,0.83,52331,3971.92,-947,-71.88,2455716,186388.84,1313,2418,0.66,11,0,0
1303,南亞         ,20210324,-196,-14.94,52135,3972.69,-28,-2.13,2455336,187096.6,2670,2388,0.66,68,264,0
1303,南亞         ,20210325,51,3.9,52186,3992.23,584,44.68,2455799,187868.62,1951,1420,0.66,51,0,0
1303,南亞         ,20210326,3,0.23,52189,4034.21,4021,310.82,2459809,190143.24,3835,1384,0.66,3,0,0
1303,南亞         ,20210329,0,0,52189,4117.71,4927,388.74,2464895,194480.22,5898,2693,0.66,0,0,0
1303,南亞         ,20210330,174,13.75,52363,4136.68,3176,250.9,2468844,195038.68,5872,2973,0.66,174,0,0
1303,南亞         ,20210331,1,0.05,51143,4081.21,2178,173.8,2456668,196042.11,5332,3801,0.64,6,5,0
1303,南亞         ,20210401,167,13.31,51310,4084.28,192,15.28,2457082,195583.73,3408,3678,0.65,211,44,0
1303,南亞         ,20210406,-76,-6.08,51234,4098.72,2949,235.92,2460033,196802.64,4206,1061,0.65,0,76,0
1303,南亞         ,20210407,-9,-0.72,51225,4103.12,209,16.74,2460481,197084.53,2159,2020,0.65,94,103,0
1303,南亞         ,20210408,47,3.76,51272,4106.89,-178,-14.26,2460298,197069.87,2330,2489,0.65,57,10,0
1303,南亞         ,20210409,283,23.29,51555,4242.98,5916,486.89,2466218,202969.74,7418,3598,0.65,448,165,0
1303,南亞         ,20210412,2418,206.73,53973,4614.69,7557,646.12,2473807,211510.5,10643,5188,0.68,2518,100,0.02
1303,南亞         ,20210413,543,47.15,54516,4731.99,1211,105.11,2474784,214811.25,5846,4556,0.69,552,9,0
1303,南亞         ,20210414,6,0.48,54522,4716.15,2624,226.98,2477295,214286.02,6329,2418,0.69,6,0,0
1303,南亞         ,20210415,1657,147.47,56179,4999.93,7339,653.17,2484406,221112.13,8269,3272,0.71,1657,0,0.01
1303,南亞         ,20210416,1151,103.47,57330,5153.97,2600,233.74,2487062,223586.87,5696,4522,0.72,1156,5,0.01
1303,南亞         ,20210419,720,65.61,58050,5288.36,4692,427.44,2491873,227009.63,5438,1767,0.73,720,0,0
1303,南亞         ,20210420,1847,168.28,59897,5456.62,4828,439.83,2496265,227409.74,7684,3910,0.76,1882,35,0.01
1303,南亞         ,20210421,50,4.49,59947,5407.22,6001,541.29,2502740,225747.15,10921,3840,0.76,210,160,0
1303,南亞         ,20210422,810,73.06,60757,5480.28,9729,877.56,2513562,226723.29,13291,3166,0.77,810,0,0.01
1303,南亞         ,20210423,-7,-0.62,60750,5467.5,5384,484.56,2519639,226767.51,8383,2590,0.77,2,9,0
1303,南亞         ,20210426,-1878,-169.02,58872,5298.48,2819,253.71,2522782,227050.38,6453,1106,0.74,0,1878,0.01
1303,南亞         ,20210427,-49,-4.5,58823,5399.95,11920,1094.26,2534980,232711.16,15508,3283,0.74,37,86,0
1303,南亞         ,20210428,-63,-5.64,58760,5264.9,-1357,-121.59,2535353,227167.63,5071,4632,0.74,0,63,0
1303,南亞         ,20210429,-1986,-175.13,56774,5007.47,672,59.27,2539668,223998.72,9736,3437,0.72,3,1989,0.01
1303,南亞         ,20210503,-176,-15.47,56598,4974.96,3821,335.87,2543984,223616.19,7217,2708,0.71,16,192,0
1303,南亞         ,20210504,25,2.15,56623,4920.54,1967,170.93,2546258,221269.82,10818,8985,0.71,25,0,0
1303,南亞         ,20210505,-423,-37.18,56200,4945.6,1719,151.27,2547907,224215.82,7864,5351,0.71,196,619,0.01
1303,南亞         ,20210506,-47,-4.21,56153,5031.31,1690,151.42,2549706,228453.66,6992,5147,0.71,159,206,0
1303,南亞         ,20210507,-27,-2.39,56126,4972.76,-1582,-140.17,2549006,225841.93,5256,6396,0.71,9,36,0
1303,南亞         ,20210510,18,1.62,56144,4996.82,4169,371.04,2552636,227184.6,6193,1968,0.71,18,0,0
1303,南亞         ,20210511,477,40.98,56621,4863.74,-1400,-120.26,2551940,219211.65,4243,5393,0.71,477,0,0
1303,南亞         ,20210512,423,34.18,57044,4609.16,5741,463.87,2557717,206663.53,15427,9976,0.72,423,0,0
1303,南亞         ,20210513,48,3.79,57092,4510.27,-1663,-131.38,2556083,201930.56,8998,10668,0.72,48,0,0
1303,南亞         ,20210514,543,43.66,57635,4633.85,1294,104.04,2557136,205593.73,6200,4671,0.73,543,0,0
1303,南亞         ,20210517,24,1.87,57659,4491.64,205,15.97,2557306,199214.14,6140,6158,0.73,24,0,0
1303,南亞         ,20210518,25,2.03,57684,4689.71,1524,123.9,2558436,208000.85,4307,3161,0.73,25,0,0
1303,南亞         ,20210519,0,0,57684,4718.55,-237,-19.39,2558356,209273.52,3945,4025,0.73,0,0,0
1303,南亞         ,20210520,0,0,57684,4701.25,-231,-18.83,2557631,208446.93,5819,5742,0.73,0,0,0
1303,南亞         ,20210521,-27,-2.22,57657,4750.94,-36,-2.97,2557419,210731.33,2808,2944,0.73,0,27,0
1303,南亞         ,20210524,0,0,57657,4710.58,-1294,-105.72,2555977,208823.32,2602,4041,0.73,0,0,0
1303,南亞         ,20210525,910,76.71,58567,4937.2,927,78.15,2556779,215536.47,4073,4052,0.74,923,13,0.01
1303,南亞         ,20210526,-773,-64.39,57794,4814.24,-2111,-175.85,2554746,212810.34,2577,4006,0.73,4,777,0
1303,南亞         ,20210527,-1148,-94.25,56646,4650.64,-1546,-126.93,2553441,209637.51,12653,12948,0.71,12,1160,0.01
1303,南亞         ,20210528,-330,-27.56,56316,4702.39,1740,145.29,2556479,213466,5786,3785,0.71,1,331,0
1303,南亞         ,20210531,-595,-50.19,55721,4702.85,537,45.32,2556943,215805.99,4794,3735,0.7,0,595,0
1303,南亞         ,20210601,-208,-17.68,55513,4718.6,-209,-17.77,2556053,217264.51,1629,1780,0.7,0,208,0
1303,南亞         ,20210602,0,-0.03,55513,4807.43,2304,199.53,2558363,221554.24,4864,3388,0.7,0,0,0
1303,南亞         ,20210603,-1,-0.08,55512,4823.99,-228,-19.81,2558134,222301.84,3670,4009,0.7,0,1,0
1303,南亞         ,20210604,0,-0.04,55512,4774.03,-717,-61.66,2557418,219937.95,2014,2565,0.7,0,0,0
1303,南亞         ,20210607,5,0.47,55517,4752.26,-228,-19.52,2557229,218898.8,1888,2110,0.7,6,1,0
1303,南亞         ,20210608,-400,-34,55117,4684.95,-99,-8.41,2557151,217357.84,2697,2121,0.69,14,414,0
1303,南亞         ,20210609,-1119,-94.89,53998,4579.03,500,42.4,2557116,216843.44,5835,3713,0.68,0,1119,0.01
1303,南亞         ,20210610,114,9.78,54112,4642.81,2042,175.2,2558650,219532.17,3697,1841,0.68,122,8,0
1303,南亞         ,20210611,-195,-16.59,53917,4588.34,177,15.06,2558428,217722.22,1630,1248,0.68,31,226,0
1303,南亞         ,20210615,-2,-0.17,53915,4571.99,-1197,-101.51,2557337,216862.18,1129,2398,0.68,0,2,0
1303,南亞         ,20210616,-837,-71.11,53078,4511.63,1353,115.01,2558290,217454.65,3264,2152,0.67,0,837,0.01
1303,南亞         ,20210617,136,11.55,53214,4517.87,-159,-13.5,2557617,217141.68,1714,1980,0.67,136,0,0
1303,南亞         ,20210618,-3643,-299.82,49571,4079.69,-8978,-738.89,2548987,209781.63,9031,13771,0.63,135,3778,0.02
1303,南亞         ,20210621,172,14.04,49743,4049.08,1385,112.74,2549993,207569.43,5739,4169,0.63,172,0,0
1303,南亞         ,20210622,-38,-3.11,49705,4070.84,1076,88.12,2550869,208916.17,2549,1545,0.63,170,208,0
1303,南亞         ,20210623,30,2.48,49735,4118.06,6368,527.27,2557267,211741.71,5470,1344,0.63,30,0,0
1303,南亞         ,20210624,27,2.24,49762,4130.25,558,46.31,2557825,212299.48,1324,1151,0.63,30,3,0
1303,南亞         ,20210625,-316,-26.23,49446,4104.02,1968,163.34,2559937,212474.77,4178,2358,0.62,15,331,0
1303,南亞         ,20210628,2,0.17,49448,4119.02,911,75.89,2561111,213340.55,1620,793,0.62,20,18,0
1303,南亞         ,20210629,507,42.23,49955,4161.25,-179,-14.91,2561753,213394.02,2634,3329,0.63,514,7,0
1303,南亞         ,20210630,406,33.78,60491,5032.85,1110,92.35,2569454,213778.57,4937,4263,0.76,406,0,0
1303,南亞         ,20210701,563,47.24,61054,5122.43,550,46.15,2570121,215633.15,4410,4305,0.77,563,0,0
1303,南亞         ,20210702,684,57.8,61738,5216.86,1096,92.61,2571406,217283.81,3940,3441,0.78,708,24,0
1303,南亞         ,20210705,87,7.49,61825,5347.86,3313,286.57,2575236,222757.91,4594,2478,0.78,353,266,0
1303,南亞         ,20210706,0,0,61825,5310.77,-360,-30.92,2574680,221165.01,1911,2593,0.78,0,0,0
1303,南亞         ,20210707,-5,-0.43,61820,5353.61,1709,148,2576479,223123.08,4316,2602,0.78,0,5,0
1303,南亞         ,20210708,-4,-0.33,61816,5285.27,-1107,-94.65,2574939,220157.28,2081,3338,0.78,11,15,0
1303,南亞         ,20210709,25,2.16,61841,5336.88,60,5.18,2574062,222141.55,4973,5434,0.78,25,0,0
1303,南亞         ,20210712,641,55.13,62482,5373.45,-692,-59.51,2572780,221259.08,4222,4990,0.79,759,118,0.01
1303,南亞         ,20210713,-11,-0.93,62471,5428.73,4648,403.91,2577695,224001.7,6981,2162,0.79,0,11,0
1303,南亞         ,20210714,100,8.72,62571,5456.19,2293,199.95,2579828,224961,4386,2189,0.79,919,819,0.01
1303,南亞         ,20210715,258,22.66,62829,5522.67,1852,162.79,2581838,226943.56,3021,1459,0.79,281,23,0
1303,南亞         ,20210716,-81,-7.21,62748,5584.57,3574,318.09,2586872,230231.61,5222,1994,0.79,0,81,0
1303,南亞         ,20210719,251,22.06,62999,5537.61,-3006,-264.23,2583867,227121.91,3678,6976,0.79,251,0,0
1303,南亞         ,20210720,-76,-6.54,62923,5411.38,776,66.74,2584643,222279.3,2480,1221,0.79,8,84,0
1303,南亞         ,20210721,34,2.91,62957,5389.12,517,44.26,2585160,221289.7,3293,3114,0.79,34,0,0
1303,南亞         ,20210722,889,78.09,63846,5605.68,7603,667.54,2592299,227603.85,9026,2461,0.81,889,0,0.01
1303,南亞         ,20210723,346,30.45,64192,5648.9,2229,196.15,2594528,228318.46,3089,1221,0.81,346,0,0
1303,南亞         ,20210726,337,29.05,64529,5562.4,-1499,-129.21,2593030,223519.19,1983,3961,0.81,344,7,0
1303,南亞         ,20210727,697,59.94,65226,5609.44,3156,271.42,2594829,223155.29,5232,2840,0.82,697,0,0
1303,南亞         ,20210728,167,14.22,65393,5578.02,1642,140.06,2595806,221422.25,7646,7214,0.82,167,0,0
1303,南亞         ,20210729,9,0.81,65402,5644.19,1616,139.46,2597421,224157.43,4299,2600,0.82,16,7,0
1303,南亞         ,20210730,-1,-0.05,65401,5689.89,2353,204.71,2596527,225897.85,4596,2619,0.82,2,3,0
1303,南亞         ,20210802,0,0.01,65401,5807.61,4910,436.01,2601437,231007.61,5516,1225,0.82,1,1,0
1303,南亞         ,20210803,99,8.75,65500,5790.2,258,22.81,2601696,229989.93,2802,2906,0.83,105,6,0
1303,南亞         ,20210804,16,1.38,65516,5785.06,800,70.64,2602417,229793.42,1746,1164,0.83,20,4,0
1303,南亞         ,20210805,-473,-41.55,65043,5710.78,-26,-2.28,2602391,228489.93,1935,1369,0.82,0,473,0
1303,南亞         ,20210806,32,2.83,65075,5752.63,1004,88.75,2603395,230140.12,3866,2892,0.82,34,2,0
1303,南亞         ,20210809,1,0.09,65076,5746.21,891,78.68,2604286,229958.45,4203,3345,0.82,1,0,0
1303,南亞         ,20210810,186,16.18,65262,5677.79,1315,114.41,2605601,226687.29,3389,2114,0.82,186,0,0
1303,南亞         ,20210811,116,10.18,65378,5740.19,3302,289.92,2608903,229061.68,4398,1369,0.82,116,0,0
1303,南亞         ,20210812,138,12.12,65516,5752.3,821,72.08,2609730,229134.29,2245,1603,0.83,138,0,0
1303,南亞         ,20210813,250,21.6,65766,5682.18,-420,-36.29,2609310,225444.38,2264,2211,0.83,250,0,0
1303,南亞         ,20210816,-112,-9.62,65654,5639.68,1622,139.33,2610932,224279.06,3578,1748,0.83,138,250,0
1303,南亞         ,20210817,269,23.16,65923,5675.97,1887,162.47,2612752,224957.95,4523,2862,0.83,269,0,0
1303,南亞         ,20210818,81,7.04,66004,5735.75,2437,211.78,2615190,227260.01,4441,2261,0.83,81,0,0
1303,南亞         ,20210819,326,27.38,66330,5571.72,-3295,-276.78,2611795,219390.78,3114,6368,0.84,326,0,0
1303,南亞         ,20210820,169,13.8,66499,5446.27,104,8.52,2611599,213889.96,3986,3928,0.84,169,0,0
1303,南亞         ,20210823,51,4.26,66550,5563.58,1469,122.81,2613103,218455.41,2410,884,0.84,51,0,0
1303,南亞         ,20210824,27,2.29,66577,5652.39,1533,130.15,2615016,222014.86,3122,1633,0.84,27,0,0
1303,南亞         ,20210825,17,1.44,66594,5673.81,315,26.84,2615291,222822.79,2114,1856,0.84,17,0,0
1303,南亞         ,20210826,224,18.95,66818,5652.8,-3432,-290.35,2611902,220966.91,1632,5245,0.84,225,1,0
1303,南亞         ,20210827,0,0,66818,5766.39,4230,365.05,2615912,225753.21,4497,779,0.84,0,0,0
1303,南亞         ,20210830,20,1.75,66838,5855.01,2417,211.73,2618382,229370.26,3630,1290,0.84,20,0,0
1303,南亞         ,20210831,66,5.91,66904,5994.6,4858,435.28,2622756,234998.94,10433,5882,0.84,66,0,0
1303,南亞         ,20210901,-6,-0.53,66898,5920.47,-367,-32.48,2622622,232102.05,3641,4133,0.84,0,6,0
1303,南亞         ,20210902,-9,-0.81,66889,5852.79,732,64.05,2624067,229605.86,1983,1183,0.84,2,11,0
1303,南亞         ,20210903,4,0.34,66893,5886.58,2801,246.49,2626868,231164.38,3768,1362,0.84,14,10,0
1303,南亞         ,20210906,-17,-1.51,66876,5851.65,589,51.54,2627510,229907.13,1293,559,0.84,3,20,0
1303,南亞         ,20210907,-3,-0.24,66873,5864.76,459,40.25,2627973,230473.23,2479,1927,0.84,9,12,0
1303,南亞         ,20210908,140,12.24,67013,5856.94,1133,99.02,2629481,229816.64,5426,3813,0.84,146,6,0
1303,南亞         ,20210909,-9,-0.78,67004,5829.35,694,60.38,2630247,228831.49,4108,3361,0.84,0,9,0
1303,南亞         ,20210910,-9,-0.79,66995,5888.86,1516,133.26,2631939,231347.44,2416,741,0.84,0,9,0
1303,南亞         ,20210913,0,0,66995,5929.06,2275,201.34,2634299,233135.46,3314,990,0.84,0,0,0
1303,南亞         ,20210914,313,27.73,67308,5963.49,2309,204.58,2636488,233592.84,4380,2533,0.85,313,0,0
1303,南亞         ,20210915,1326,117.88,68634,6101.56,2958,262.97,2640082,234703.29,4311,2297,0.87,1329,3,0.01
1303,南亞         ,20210916,1451,131.32,70085,6342.69,7799,705.81,2649357,239766.81,8136,2688,0.88,1451,0,0.01
1303,南亞         ,20210917,-88,-7.94,69997,6292.73,551,49.53,2650200,238252.98,10283,9808,0.88,190,278,0
1303,南亞         ,20210922,496,43.3,70493,6154.04,-5125,-447.41,2645641,230964.46,3475,7971,0.89,496,0,0
1303,南亞         ,20210923,8,0.71,70501,6267.54,3415,303.59,2648749,235473.79,4962,1589,0.89,8,0,0
1303,南亞         ,20210924,0,0,70501,6436.74,3756,342.92,2652054,242132.53,5781,2635,0.89,0,0,0
1303,南亞         ,20210927,605,55.72,71106,6548.86,4890,450.37,2657014,244710.99,6212,2265,0.9,605,0,0
1303,南亞         ,20210928,39,3.62,71145,6602.26,2729,253.25,2659506,246802.16,6301,3654,0.9,39,0,0
1303,南亞         ,20210929,917,83.26,72062,6543.23,1084,98.43,2661465,241661.02,6574,5325,0.91,942,25,0.01
1303,南亞         ,20210930,181,16.56,69993,6404.36,1080,98.82,2660543,243439.68,6342,5446,0.88,183,2,0
1303,南亞         ,20211001,377,33.25,70370,6206.63,-6769,-597.03,2652921,233987.63,2028,9021,0.89,377,0,0
1303,南亞         ,20211004,437,38.11,70807,6174.37,3131,273.02,2655222,231535.36,4827,2183,0.89,437,0,0
1303,南亞         ,20211005,283,25.16,71090,6319.9,3009,267.5,2657956,236292.29,7754,5171,0.9,283,0,0
1303,南亞         ,20211006,382,34.38,71472,6432.48,4436,399.24,2662105,239589.45,10381,6031,0.9,382,0,0
1303,南亞         ,20211007,40,3.63,71512,6486.14,5610,508.83,2667394,241932.64,9163,3946,0.9,47,7,0
1303,南亞         ,20211008,72,6.57,71584,6535.62,2315,211.36,2669861,243758.31,4908,2538,0.9,73,1,0
1303,南亞         ,20211012,95,8.42,71679,6350.76,-5798,-513.7,2664544,236078.6,4178,9984,0.9,95,0,0
1303,南亞         ,20211013,191,16.98,71870,6389.24,912,81.08,2665326,236947.48,4254,3623,0.91,191,0,0
1303,南亞         ,20211014,31,2.73,71901,6341.67,302,26.64,2665609,235106.71,2333,2081,0.91,31,0,0
1303,南亞         ,20211015,0,0,71901,6413.57,2113,188.48,2668171,238000.85,5304,2636,0.91,0,0,0
1303,南亞         ,20211018,97,8.59,71998,6371.82,642,56.82,2668738,236183.31,2111,1641,0.91,97,0,0
1303,南亞         ,20211019,0,0,71998,6400.62,879,78.14,2669793,237344.6,3326,2555,0.91,0,0,0
1303,南亞         ,20211020,0,0,71998,6415.02,1831,163.14,2671354,238017.64,5920,4384,0.91,0,0,0
1303,南亞         ,20211021,-7,-0.63,71991,6428.8,1111,99.21,2672564,238659.97,3717,2606,0.91,0,7,0
1303,南亞         ,20211022,155,13.7,72146,6377.71,-1232,-108.91,2671480,236158.83,1193,2595,0.91,155,0,0
1303,南亞         ,20211025,36,3.18,72182,6366.45,-1163,-102.58,2670826,235566.85,2311,3324,0.91,36,0,0
1303,南亞         ,20211026,-566,-50.26,71616,6359.5,856,76.01,2671707,237247.58,11903,10457,0.9,197,763,0.01
1303,南亞         ,20211027,-1440,-126.58,70176,6168.47,-3336,-293.23,2668643,234573.72,2955,4618,0.88,98,1538,0.01
1303,南亞         ,20211028,-1086,-93.4,69090,5941.74,-7656,-658.42,2661415,228881.69,1665,7810,0.87,40,1126,0.01
1303,南亞         ,20211029,-109,-9.28,68981,5870.28,-2294,-195.22,2659494,226322.94,3814,5569,0.87,186,295,0
1303,南亞         ,20211101,12,1.02,68993,5857.51,-1554,-131.93,2658267,225686.87,1892,3158,0.87,12,0,0
1303,南亞         ,20211102,210,17.85,69203,5882.26,-1181,-100.39,2657215,225863.28,4085,5347,0.87,210,0,0
1303,南亞         ,20211103,-23,-1.95,69180,5859.55,-3039,-257.4,2654323,224821.16,2515,5490,0.87,15,38,0
1303,南亞         ,20211104,15,1.28,69195,5888.49,-436,-37.1,2653871,225844.42,3560,4027,0.87,18,3,0
1303,南亞         ,20211105,287,24.37,69482,5899.02,-1404,-119.2,2652518,225198.78,3289,4929,0.88,287,0,0
1303,南亞         ,20211108,41,3.51,69523,5958.12,492,42.16,2653026,227364.33,3554,3193,0.88,68,27,0
1303,南亞         ,20211109,43,3.73,69566,5968.76,-347,-29.77,2652595,227592.65,5144,5677,0.88,51,8,0
1303,南亞         ,20211110,168,14.31,69734,5941.34,-1359,-115.79,2651625,225918.45,3919,5816,0.88,168,0,0
1303,南亞         ,20211111,60,5.12,69794,5953.43,4380,373.61,2656052,226561.24,8565,4254,0.88,60,0,0
1303,南亞         ,20211112,55,4.73,69849,6007.01,1480,127.28,2657532,228547.75,2709,1515,0.88,55,0,0
1303,南亞         ,20211115,-45,-3.87,69804,5996.16,33,2.83,2658126,228333.02,3115,3071,0.88,112,157,0
1303,南亞         ,20211116,499,42.86,70303,6039.03,2839,243.87,2660727,228556.45,4656,2306,0.89,545,46,0
1303,南亞         ,20211117,-810,-69.34,69493,5948.6,-3904,-334.18,2657030,227441.77,2744,8696,0.88,116,926,0.01
1303,南亞         ,20211118,-214,-18.4,69279,5957.99,2064,177.5,2658858,228661.79,3884,1778,0.87,48,262,0
1303,南亞         ,20211119,31,2.64,69310,5891.35,-1100,-93.5,2657840,225916.4,2697,3879,0.87,33,2,0
1303,南亞         ,20211122,0,0,69310,5926.01,2574,220.08,2660493,227472.15,4539,1995,0.87,0,0,0
1303,南亞         ,20211123,0,0,69310,5932.94,1628,139.36,2662105,227876.19,4425,2906,0.87,0,0,0
