證券名稱,簡稱,年月日,投信買賣超(千股),投信買賣超市值(百萬),投信持股數(千股),投信持股數市值(百萬),合計買賣超(千股),合計買賣超市值(百萬),合計持股數(千股),合計持股數市值(百萬),外資買進張數,外資賣出張數,投信持股率%,投信買進張數,投信賣出張數,投信週轉率%
1326,台化         ,20130102,312,23.52,53053,4000.2,2447,184.5,2058981,155247.17,3034,866,0.93,362,50,0
1326,台化         ,20130103,606,47.15,53659,4174.67,4539,353.13,2063550,160544.19,4521,842,0.94,613,7,0.01
1326,台化         ,20130104,454,35.68,54113,4253.28,5222,410.45,2068772,162605.48,6907,2057,0.95,468,14,0
1326,台化         ,20130107,53,4.16,54166,4252.03,2355,184.87,2071127,162583.47,4549,1817,0.95,404,351,0.01
1326,台化         ,20130108,-124,-9.72,54042,4236.89,629,49.31,2070866,162355.89,2792,1558,0.95,0,124,0
1326,台化         ,20130109,-26,-2.02,54016,4191.64,1258,97.62,2072150,160798.84,3029,1713,0.95,0,26,0
1326,台化         ,20130110,62,4.82,54078,4207.27,2738,213.02,2075249,161454.37,6899,3645,0.95,62,0,0
1326,台化         ,20130111,-16,-1.26,54062,4249.27,1889,148.48,2077146,163263.68,2259,356,0.95,150,166,0
1326,台化         ,20130114,20,1.55,54082,4191.35,-494,-38.28,2076828,160954.17,2690,3007,0.95,135,115,0
1326,台化         ,20130115,-139,-10.86,53943,4212.95,570,44.52,2077737,162271.26,3644,2616,0.95,0,139,0
1326,台化         ,20130116,-48,-3.73,53895,4193.03,869,67.61,2078673,161720.76,3114,2170,0.95,0,48,0
1326,台化         ,20130117,-225,-17.55,53670,4186.26,1817,141.73,2080370,162268.86,8937,6442,0.94,0,225,0
1326,台化         ,20130118,35,2.77,53705,4242.7,2060,162.74,2082670,164530.93,3291,1133,0.94,35,0,0
1326,台化         ,20130121,-37,-2.96,53668,4293.44,2372,189.76,2085081,166806.48,4029,1810,0.94,0,37,0
1326,台化         ,20130122,-170,-13.6,53498,4279.84,1458,116.64,2086542,166923.36,3760,2178,0.94,0,170,0
1326,台化         ,20130123,-39,-3.08,53459,4223.26,784,61.94,2087369,164902.15,2031,1165,0.94,0,39,0
1326,台化         ,20130124,-36,-2.8,53423,4161.65,-54,-4.21,2087327,162602.77,1542,1450,0.94,2,38,0
1326,台化         ,20130125,-878,-67.96,52545,4066.98,-98,-7.59,2087217,161550.6,3512,2794,0.92,0,878,0.01
1326,台化         ,20130128,-1096,-85.27,51449,4002.73,461,35.87,2087753,162427.18,2079,411,0.9,0,1096,0.01
1326,台化         ,20130129,-605,-47.43,50844,3986.17,1611,126.3,2089398,163808.8,2640,339,0.89,0,605,0.01
1326,台化         ,20130130,-110,-8.77,50734,4043.5,2636,210.09,2092183,166746.99,4863,1968,0.89,0,110,0
1326,台化         ,20130131,-17,-1.36,50717,4067.5,3556,285.19,2095307,168043.62,6512,2729,0.89,20,37,0
1326,台化         ,20130201,0,0,50717,4057.36,1056,84.48,2096473,167717.84,3717,2551,0.89,0,0,0
1326,台化         ,20130204,-16,-1.29,50701,4076.36,2350,188.94,2099008,168760.24,4051,1628,0.89,3,19,0
1326,台化         ,20130205,-1025,-80.98,49676,3924.4,-236,-18.64,2098810,165805.99,3862,3105,0.87,0,1025,0.01
1326,台化         ,20130206,-498,-39.32,49178,3885.06,1526,120.55,2100765,165960.44,5927,3404,0.86,3,501,0
1326,台化         ,20130218,-84,-6.48,49094,3790.06,-2202,-169.99,2098892,162034.46,6497,8396,0.86,0,84,0
1326,台化         ,20130219,-307,-23.67,48787,3761.48,259,19.97,2099323,161857.8,1581,843,0.86,0,307,0
1326,台化         ,20130220,-295,-22.95,48492,3772.68,732,56.95,2099465,163338.38,3747,3440,0.85,0,295,0
1326,台化         ,20130221,-70,-5.42,48422,3747.86,1137,88,2101570,162661.52,6350,4960,0.85,0,70,0
1326,台化         ,20130222,-26,-2.02,48396,3755.53,117,9.08,2100866,163027.2,1895,1689,0.85,0,26,0
1326,台化         ,20130223,-67,-5.2,48329,3750.33,338,26.23,2101369,163066.23,581,11,0.85,0,67,0
1326,台化         ,20130225,-41,-3.18,48288,3742.32,187,14.49,2101716,162882.99,4415,4027,0.85,0,41,0
1326,台化         ,20130226,-404,-31.19,47884,3696.64,-522,-40.3,2101236,162215.42,11199,11285,0.84,0,404,0
1326,台化         ,20130227,-202,-15.27,47682,3604.76,-967,-73.11,2100726,158814.89,2895,3604,0.84,0,202,0
1326,台化         ,20130301,-153,-11.64,47529,3616.96,-161,-12.25,2100674,159861.29,3643,3542,0.84,0,153,0
1326,台化         ,20130304,-205,-15.03,47324,3468.85,-5160,-378.23,2095405,153593.19,4569,9726,0.83,0,205,0
1326,台化         ,20130305,-310,-22.88,47014,3469.63,-1442,-106.42,2094220,154553.44,3507,4289,0.83,0,310,0
1326,台化         ,20130306,-251,-18.77,46763,3497.87,-166,-12.42,2092947,156552.44,2275,2131,0.82,0,251,0
1326,台化         ,20130307,-32,-2.4,46731,3504.83,-22,-1.65,2092951,156971.33,708,673,0.82,0,32,0
1326,台化         ,20130308,-44,-3.33,46687,3529.54,680,51.41,2093528,158270.72,5780,5159,0.82,0,44,0
1326,台化         ,20130311,-539,-40.86,46148,3498.02,-1269,-96.19,2092945,158645.23,3146,3682,0.81,0,539,0
1326,台化         ,20130312,-90,-6.8,46058,3477.38,-488,-36.84,2092484,157982.54,718,1089,0.81,0,90,0
1326,台化         ,20130313,-246,-18.2,45812,3390.09,-2350,-173.9,2090337,154684.94,795,2696,0.81,0,246,0
1326,台化         ,20130314,-6,-0.44,45806,3353,-1350,-98.82,2089935,152983.24,1203,2399,0.8,0,6,0
1326,台化         ,20130315,3270,241.65,49076,3626.72,825,60.97,2091043,154528.08,1926,4188,0.86,3287,17,0.03
1326,台化         ,20130318,23,1.67,49099,3554.77,-2841,-205.69,2087936,151166.57,624,3478,0.86,33,10,0
1326,台化         ,20130319,-12,-0.86,49087,3534.26,-2196,-158.11,2085707,150170.9,1171,3388,0.86,0,12,0
1326,台化         ,20130320,-14,-0.99,49073,3459.65,-2925,-206.21,2082580,146821.89,1022,4135,0.86,0,14,0
1326,台化         ,20130321,0,0,49073,3459.65,-1143,-80.58,2081441,146741.59,929,2068,0.86,0,0,0
1326,台化         ,20130322,-7,-0.49,49066,3449.34,-427,-30.02,2081033,146296.62,960,1411,0.86,0,7,0
1326,台化         ,20130325,0,0,49066,3473.87,-400,-28.32,2080673,147311.65,586,946,0.86,0,0,0
1326,台化         ,20130326,0,0,49066,3414.99,-1494,-103.98,2079079,144703.9,408,1850,0.86,0,0,0
1326,台化         ,20130327,-59,-4.05,49007,3361.88,1017,69.77,2080069,142692.73,2160,1131,0.86,2,61,0
1326,台化         ,20130328,-257,-17.19,48750,3261.38,-3114,-208.33,2076616,138925.61,2332,5508,0.86,0,257,0
1326,台化         ,20130329,2,0.14,43690,3005.87,815,56.07,2072147,142563.71,2156,1565,0.77,2,0,0
1326,台化         ,20130401,-4,-0.28,43686,3036.18,568,39.48,2072730,144054.73,856,393,0.77,0,4,0
1326,台化         ,20130402,-4,-0.28,43682,3075.21,-194,-13.66,2072716,145919.21,1817,1922,0.77,0,4,0
1326,台化         ,20130403,-16,-1.1,43666,3004.22,-2201,-151.43,2070565,142454.87,965,3256,0.77,0,16,0
1326,台化         ,20130408,-444,-29.79,43222,2900.2,-4211,-282.56,2066592,138668.32,1107,4926,0.76,0,444,0
1326,台化         ,20130409,94,6.31,43316,2906.5,-3076,-206.4,2063516,138461.92,861,3987,0.76,100,6,0
1326,台化         ,20130410,0,0,43316,2897.84,-262,-17.53,2063289,138034.03,4088,4362,0.76,0,0,0
1326,台化         ,20130411,-94,-6.35,43222,2917.49,-1394,-94.1,2061925,139179.94,1559,2976,0.76,0,94,0
1326,台化         ,20130412,-1,-0.07,43221,2939.03,-1726,-117.37,2060199,140093.53,1005,2781,0.76,0,1,0
1326,台化         ,20130415,-4,-0.27,43217,2912.83,-1016,-68.48,2059223,138791.63,344,1336,0.76,0,4,0
1326,台化         ,20130416,-44,-2.95,43173,2896.91,-890,-59.72,2057963,138089.32,1130,2022,0.76,0,44,0
1326,台化         ,20130417,-107,-7.19,43066,2894.04,-1197,-80.44,2056448,138193.31,3041,4094,0.76,20,127,0
1326,台化         ,20130418,0,0,43066,2876.81,-1394,-93.12,2055074,137278.94,321,1683,0.76,0,0,0
1326,台化         ,20130419,16,1.09,43082,2903.73,429,28.91,2055503,138540.9,1024,548,0.76,16,0,0
1326,台化         ,20130422,-25,-1.7,43057,2919.26,-54,-3.66,2055450,139359.51,499,620,0.76,0,25,0
1326,台化         ,20130423,125,8.5,43182,2936.38,-978,-66.5,2054472,139704.1,878,2025,0.76,150,25,0
1326,台化         ,20130424,50,3.48,43232,3008.95,-1298,-90.34,2053194,142902.3,1704,3461,0.76,55,5,0
1326,台化         ,20130425,198,13.82,43430,3031.41,-642,-44.81,2052602,143271.62,2743,3243,0.76,214,16,0
1326,台化         ,20130426,-8,-0.56,43422,3017.83,-1091,-75.82,2051570,142584.12,2943,3970,0.76,0,8,0
1326,台化         ,20130429,12,0.83,43434,3005.63,41,2.84,2051883,141990.3,2152,2208,0.76,25,13,0
1326,台化         ,20130430,-115,-7.95,43319,2993.34,-1758,-121.48,2049699,141634.2,3693,5356,0.76,290,405,0.01
1326,台化         ,20130502,36,2.48,43355,2987.16,-1204,-82.96,2048505,141141.99,2418,3933,0.76,50,14,0
1326,台化         ,20130503,-60,-4.12,43295,2974.37,-3689,-253.43,2044616,140465.12,1333,4751,0.76,0,60,0
1326,台化         ,20130506,121,8.47,43416,3039.12,-969,-67.83,2043647,143055.29,2489,4236,0.76,140,19,0
1326,台化         ,20130507,109,7.78,43525,3107.69,-47,-3.36,2043715,145921.25,1540,1996,0.76,110,1,0
1326,台化         ,20130508,307,22.41,43832,3199.74,2565,187.25,2047371,149458.08,4794,3017,0.77,310,3,0
1326,台化         ,20130509,64,4.7,43896,3226.36,569,41.82,2048076,150533.59,2112,1591,0.77,75,11,0
1326,台化         ,20130510,25,1.84,43921,3236.98,1879,138.48,2049985,151083.89,3400,1603,0.77,115,90,0
1326,台化         ,20130513,24,1.76,43945,3225.56,709,52.04,2050723,150523.07,1345,414,0.77,35,11,0
1326,台化         ,20130514,33,2.42,43978,3227.99,1134,83.24,2052099,150624.07,3182,1939,0.77,36,3,0
1326,台化         ,20130515,-612,-45.47,43366,3222.09,1191,88.49,2053440,152570.59,4374,1655,0.76,0,612,0.01
1326,台化         ,20130516,1353,102.56,44719,3389.7,3248,246.2,2056738,155900.74,3103,1290,0.79,1353,0,0.01
1326,台化         ,20130517,275,20.57,44994,3365.55,526,39.34,2057274,153884.1,953,695,0.79,296,21,0
1326,台化         ,20130520,-168,-12.45,44826,3321.61,1078,79.88,2058392,152526.85,2033,770,0.79,0,168,0
1326,台化         ,20130521,0,0,44826,3339.54,367,27.34,2058172,153333.81,1526,947,0.79,0,0,0
1326,台化         ,20130522,-25,-1.86,44801,3328.71,373,27.71,2058853,152972.78,2016,1633,0.79,0,25,0
1326,台化         ,20130523,-2,-0.15,44799,3252.41,-639,-46.39,2058705,149461.98,4465,4562,0.79,0,2,0
1326,台化         ,20130524,-371,-26.49,44428,3172.16,-2006,-143.23,2057987,146940.27,4951,5887,0.78,0,371,0
1326,台化         ,20130527,-2,-0.14,44426,3185.34,-967,-69.33,2056905,147480.09,667,1711,0.78,0,2,0
1326,台化         ,20130528,-3,-0.21,44423,3171.8,-925,-66.05,2056236,146815.25,1407,2276,0.78,0,3,0
1326,台化         ,20130529,0,0,44423,3233.99,693,50.45,2056940,149745.23,1580,836,0.78,0,0,0
1326,台化         ,20130530,-150,-10.71,44273,3161.09,-2536,-181.07,2055555,146766.63,2335,4497,0.78,0,150,0
1326,台化         ,20130531,-178,-12.57,44095,3113.11,-1564,-110.42,2054075,145017.7,5334,6736,0.77,2,180,0
1326,台化         ,20130603,0,0,44095,3108.7,-1040,-73.32,2053017,144737.7,1295,2346,0.77,0,0,0
1326,台化         ,20130604,0,0,44095,3121.93,-637,-45.1,2052495,145316.65,2566,3191,0.77,0,0,0
1326,台化         ,20130605,28,1.98,44123,3119.5,-1584,-111.99,2050638,144980.11,1240,2888,0.78,58,30,0
1326,台化         ,20130606,-133,-9.24,43990,3057.31,-2941,-204.4,2047806,142322.52,1360,4137,0.77,105,238,0
1326,台化         ,20130607,-44,-3.1,43946,3093.8,-2052,-144.46,2046484,144072.47,819,2726,0.77,95,139,0
1326,台化         ,20130610,44,3.12,43990,3123.29,-416,-29.54,2046045,145269.2,656,1159,0.77,44,0,0
1326,台化         ,20130611,216,15.34,44206,3138.63,-1051,-74.62,2045243,145212.25,1207,2462,0.78,216,0,0
1326,台化         ,20130613,35,2.39,44241,3017.24,-5930,-404.43,2040329,139150.44,1355,7262,0.78,41,6,0
1326,台化         ,20130614,0,0,44241,3017.24,-2069,-141.11,2039115,139067.64,883,2981,0.78,0,0,0
1326,台化         ,20130617,404,28.52,44645,3151.94,232,16.38,2040273,144043.27,1033,1244,0.78,459,55,0
1326,台化         ,20130618,26,1.8,44671,3086.77,-3235,-223.54,2037032,140758.91,1092,4426,0.79,30,4,0
1326,台化         ,20130619,16,1.12,44687,3119.15,-2442,-170.45,2035621,142086.35,1363,4011,0.79,20,4,0
1326,台化         ,20130620,0,0,44687,3038.72,-2840,-193.12,2032759,138227.61,634,3510,0.79,0,0,0
1326,台化         ,20130621,-57,-3.77,44630,2954.51,-5322,-352.32,2028086,134259.29,17696,22401,0.78,7,64,0
1326,台化         ,20130624,221,14.92,44851,3027.44,-1850,-124.88,2025878,136746.77,1527,3434,0.79,221,0,0
1326,台化         ,20130625,300,20.07,45151,3020.6,68,4.55,2020663,135182.35,1977,2448,0.79,300,0,0
1326,台化         ,20130626,172,11.59,45323,3054.77,-1903,-128.26,2018139,136022.57,3441,5286,0.8,180,8,0
1326,台化         ,20130627,194,13.39,45517,3140.67,443,30.57,2018333,139264.98,2145,1874,0.8,207,13,0
1326,台化         ,20130628,433,31.83,45083,3313.6,507,37.26,2018641,148370.11,3891,3613,0.79,436,3,0
1326,台化         ,20130701,-280,-19.71,44803,3154.13,-1796,-126.44,2016096,141933.16,2204,3506,0.79,0,280,0
1326,台化         ,20130702,1068,75.4,45871,3238.49,-198,-13.98,2016035,142332.07,2512,3733,0.81,1500,432,0.02
1326,台化         ,20130703,1316,90.54,47187,3246.47,1251,86.07,2017296,138789.96,1639,1763,0.83,1386,70,0.01
1326,台化         ,20130704,166,11.65,47353,3324.18,1702,119.48,2018912,141727.62,1725,313,0.83,266,100,0
1326,台化         ,20130705,331,23.57,47684,3395.1,2341,166.68,2020904,143888.36,2755,1244,0.84,352,21,0
1326,台化         ,20130708,1427,100.6,49111,3462.33,757,53.37,2021531,142517.94,3114,3704,0.86,1527,100,0.01
1326,台化         ,20130709,238,17.25,49349,3577.8,2126,154.14,2023637,146713.68,2613,750,0.87,238,0,0
1326,台化         ,20130710,340,24.92,49689,3642.2,1364,99.98,2024992,148431.91,1810,793,0.87,340,0,0
1326,台化         ,20130711,369,27.97,50058,3789.39,3953,299.24,2028955,153591.89,4355,1225,0.88,370,1,0
1326,台化         ,20130712,38,2.91,50096,3837.35,1579,120.95,2030571,155541.74,2837,1169,0.88,50,12,0
1326,台化         ,20130715,0,0,50096,3907.49,3009,234.7,2032006,158496.47,3100,501,0.88,0,0,0
1326,台化         ,20130716,59,4.6,50155,3912.09,3865,301.47,2035361,158758.16,4276,503,0.88,80,21,0
1326,台化         ,20130717,0,0,50155,3937.17,3631,285.03,2038805,160046.19,3955,677,0.88,0,0,0
1326,台化         ,20130718,268,21.17,50423,3983.42,4625,365.38,2043255,161417.15,4720,1231,0.89,272,4,0
1326,台化         ,20130719,95,7.44,50518,3955.56,2993,234.35,2046085,160208.46,3414,889,0.89,95,0,0
1326,台化         ,20130722,42,3.22,52076,3989.02,1821,139.49,2048857,156942.45,3256,517,0.92,42,0,0
1326,台化         ,20130723,229,17.53,52305,4006.56,-4634,-354.96,2043042,156497.02,5039,10023,0.92,229,0,0
1326,台化         ,20130724,1,0.08,52306,4027.56,1017,78.31,2043295,157333.72,2567,940,0.92,1,0,0
1326,台化         ,20130725,500,38.55,52806,4071.34,1238,95.45,2044488,157630.02,1429,574,0.93,500,0,0
1326,台化         ,20130726,26,1.99,52832,4036.36,939,71.74,2043793,156145.79,2329,1471,0.93,26,0,0
1326,台化         ,20130729,-45,-3.37,52787,3953.75,-186,-13.93,2043627,153067.66,1488,1390,0.93,0,45,0
1326,台化         ,20130730,-137,-10.47,52650,4022.46,2114,161.51,2045741,156294.61,2890,677,0.93,1,138,0
1326,台化         ,20130731,-363,-27.08,52287,3900.61,418,31.18,2044813,152543.05,3191,2357,0.92,110,473,0.01
1326,台化         ,20130801,-3,-0.23,52284,3921.3,925,69.38,2045740,153430.5,1509,579,0.92,90,93,0
1326,台化         ,20130802,-101,-7.77,52183,4012.87,2862,220.09,2048663,157542.18,4030,1872,0.92,0,101,0
1326,台化         ,20130805,77,5.98,52260,4060.6,-197,-15.31,2048520,159170,1158,1184,0.92,79,2,0
1326,台化         ,20130806,220,16.72,52480,3988.48,-2387,-181.41,2046133,155506.11,283,2922,0.92,220,0,0
1326,台化         ,20130807,416,31.41,52896,3993.65,-247,-18.65,2046498,154510.6,1179,1834,0.93,500,84,0.01
1326,台化         ,20130808,1311,98.98,54207,4092.63,-1076,-81.24,2045860,154462.43,521,2814,0.95,1311,0,0.01
1326,台化         ,20130809,607,45.22,54814,4083.64,-2414,-179.84,2043461,152237.84,248,3115,0.96,607,0,0.01
1326,台化         ,20130812,475,35.63,55289,4146.68,-423,-31.73,2043159,153236.93,133,1214,0.97,475,0,0
1326,台化         ,20130813,0,0,55289,4163.26,-783,-58.96,2042436,153795.43,806,1207,0.97,0,0,0
1326,台化         ,20130814,575,43.13,55864,4189.8,-1847,-138.53,2040523,153039.23,204,2341,0.98,575,0,0.01
1326,台化         ,20130815,7,0.53,55871,4190.33,-3379,-253.43,2037541,152815.58,228,3600,0.98,10,3,0
1326,台化         ,20130816,36,2.7,55907,4193.03,-610,-45.75,2037017,152776.28,730,1555,0.98,68,32,0
1326,台化         ,20130819,-234,-17.55,55673,4175.48,-1830,-137.25,2035460,152659.5,315,1765,0.98,6,240,0
1326,台化         ,20130820,13,0.98,55686,4176.45,-1603,-120.23,2093225,156991.88,549,2140,0.91,13,0,0
1326,台化         ,20130822,6,0.44,55692,4093.36,-6934,-509.65,2086187,153334.74,856,7845,0.91,6,0,0
1326,台化         ,20130823,10,0.75,55702,4160.94,-1304,-97.41,2085071,155754.8,874,2000,0.91,10,0,0
1326,台化         ,20130826,294,22.34,55996,4255.7,-249,-18.92,2085122,158469.27,802,1374,0.91,294,0,0
1326,台化         ,20130827,0,0,55996,4227.7,-321,-24.24,2084963,157414.71,2183,2362,0.91,0,0,0
1326,台化         ,20130828,19,1.43,56015,4201.13,-1779,-133.43,2083136,156235.2,449,2302,0.92,19,0,0
1326,台化         ,20130829,185,14.13,56200,4293.68,1101,84.12,2084223,159234.64,2411,1587,0.92,185,0,0
1326,台化         ,20130830,-76,-5.91,56124,4360.83,592,46,2084828,161991.14,2611,2000,0.92,7,83,0
1326,台化         ,20130902,140,10.86,56264,4366.09,227,17.62,2085065,161801.04,1245,1174,0.96,140,0,0
1326,台化         ,20130903,-66,-5.19,56198,4394.68,1149,89.85,2086224,163142.72,2092,946,0.96,0,66,0
1326,台化         ,20130904,0,0,56198,4417.16,1327,104.3,2087061,164042.99,2439,1399,0.96,0,0,0
1326,台化         ,20130905,-5,-0.39,56193,4433.63,63,4.97,2087315,164689.15,2434,2367,0.96,0,5,0
1326,台化         ,20130906,52,4.06,56245,4392.73,142,11.09,2087457,163030.39,1813,1715,0.96,52,0,0
1326,台化         ,20130909,224,17.7,56469,4461.05,1761,139.12,2089218,165048.22,3198,1524,0.96,227,3,0
1326,台化         ,20130910,22,1.75,56491,4491.03,2987,237.47,2092275,166335.86,4297,1415,0.96,22,0,0
1326,台化         ,20130911,1550,124,58041,4643.28,3567,285.36,2095963,167677.04,3847,1957,0.99,1607,57,0.01
1326,台化         ,20130912,998,79.62,59039,4711.31,2830,225.83,2099173,167514.01,2815,992,1.01,1042,44,0.01
1326,台化         ,20130913,245,18.97,59284,4594.51,-433,-33.56,2098740,162652.35,1702,2415,1.01,313,68,0
1326,台化         ,20130914,170,13.29,59454,4649.3,607,47.47,2099346,164168.86,470,1,1.01,170,0,0
1326,台化         ,20130916,596,47.77,60050,4816.01,5799,465.08,2106950,168977.39,5182,252,1.02,598,2,0.01
1326,台化         ,20130917,740,58.83,60790,4832.81,807,64.16,2108041,167589.26,2089,1986,1.04,745,5,0.01
1326,台化         ,20130918,-116,-9.02,60674,4720.44,-1297,-100.91,2106658,163897.99,2544,4056,1.04,415,531,0.01
1326,台化         ,20130923,-26,-2.05,60648,4791.19,1137,89.82,2107694,166507.83,3290,2251,1.03,0,26,0
1326,台化         ,20130924,-17,-1.34,60631,4777.72,-7,-0.55,2107575,166076.91,1513,1436,1.03,15,32,0
1326,台化         ,20130925,172,13.61,60803,4809.52,599,47.38,2108275,166764.55,2678,2199,1.04,452,280,0.01
1326,台化         ,20130926,-47,-3.66,60756,4726.82,-935,-72.74,2107341,163951.13,818,1490,1.04,2,49,0
1326,台化         ,20130927,576,45.45,61332,4839.09,959,75.67,2108299,166344.79,1844,1418,1.05,619,43,0.01
1326,台化         ,20130930,1276,100.29,63134,4962.33,-880,-69.17,2107075,165616.1,1365,3629,1.08,1302,26,0.01
1326,台化         ,20131001,1703,136.24,64837,5186.96,1896,151.68,2108971,168717.68,1125,1458,1.11,1729,26,0.01
1326,台化         ,20131002,1913,157.63,66750,5500.2,2956,243.57,2111927,174022.78,1938,1013,1.14,1914,1,0.02
1326,台化         ,20131003,1285,107.17,68035,5674.12,4521,377.05,2116508,176516.77,3806,946,1.16,1295,10,0.01
1326,台化         ,20131004,283,23.77,68318,5738.71,2191,184.04,2118734,177973.66,2434,345,1.17,283,0,0
1326,台化         ,20131007,173,14.19,68491,5616.26,515,42.23,2119294,173782.11,1052,1025,1.17,433,260,0.01
1326,台化         ,20131008,252,20.89,68743,5698.79,1386,114.9,2121291,175855.02,2421,923,1.17,252,0,0
1326,台化         ,20131009,-50,-4.09,68693,5619.09,878,71.82,2122169,173593.42,1499,468,1.17,0,50,0
1326,台化         ,20131011,60,4.93,68753,5651.5,746,61.32,2122985,174509.37,2850,2173,1.17,60,0,0
1326,台化         ,20131014,-151,-12.19,68602,5536.18,344,27.76,2123329,171352.65,1049,347,1.17,0,151,0
1326,台化         ,20131015,90,7.33,68692,5591.53,1231,100.2,2124819,172960.27,1922,491,1.17,100,10,0
1326,台化         ,20131016,236,19.31,68928,5638.31,496,40.57,2125345,173853.22,1038,673,1.18,253,17,0
1326,台化         ,20131017,43,3.58,68971,5745.28,1274,106.12,2126863,177167.69,1995,832,1.18,143,100,0
1326,台化         ,20131018,16,1.33,68987,5739.72,-311,-25.88,2127387,176998.6,853,1064,1.18,34,18,0
1326,台化         ,20131021,271,22.71,69258,5803.82,1271,106.51,2129173,178424.7,1624,186,1.18,401,130,0
1326,台化         ,20131022,-13,-1.06,69245,5795.81,774,64.78,2129960,178277.65,1270,560,1.18,151,164,0
1326,台化         ,20131023,1296,107.53,70541,5854.9,1198,99.43,2131792,176938.74,1261,1248,1.2,1652,356,0.02
1326,台化         ,20131024,-9,-0.75,70532,5889.42,799,66.72,2132609,178072.85,939,118,1.2,1,10,0
1326,台化         ,20131025,1000,84.6,71532,6051.61,770,65.14,2133112,180461.28,1098,1595,1.22,1000,0,0.01
1326,台化         ,20131028,-24,-2.03,71508,6049.58,335,28.34,2133617,180504,1000,541,1.22,10,34,0
1326,台化         ,20131029,1119,94.89,72627,6158.77,2114,179.27,2135676,181105.32,2175,1265,1.24,1121,2,0.01
1326,台化         ,20131030,147,12.46,72774,6171.24,2024,171.64,2137808,181286.12,2312,397,1.24,715,568,0.01
1326,台化         ,20131031,179,15.2,72953,6193.71,2863,243.07,2140807,181754.51,4140,1370,1.24,212,33,0
1326,台化         ,20131101,-27,-2.22,72926,6111.2,-337,-28.24,2140692,179389.99,531,619,1.24,0,27,0
1326,台化         ,20131104,90,7.38,73016,5987.31,-642,-52.64,2140011,175480.9,850,1621,1.25,500,410,0.01
1326,台化         ,20131105,-65,-5.27,72951,5909.03,-775,-62.78,2139228,173277.47,525,1243,1.24,0,65,0
1326,台化         ,20131106,-24,-1.94,72927,5907.09,1005,81.41,2140160,173352.96,1863,907,1.24,0,24,0
1326,台化         ,20131107,460,37.31,73387,5951.69,433,35.12,2140511,173595.44,1025,1190,1.25,500,40,0
1326,台化         ,20131108,189,15.16,73576,5900.8,-232,-18.61,2140807,171692.72,919,776,1.26,200,11,0
1326,台化         ,20131111,-909,-73.63,72667,5886.03,-1188,-96.23,2139420,173293.02,821,1299,1.24,0,909,0.01
1326,台化         ,20131112,-198,-16.22,72469,5935.21,1274,104.34,2140659,175319.97,2826,1469,1.24,1,199,0
1326,台化         ,20131113,0,0,72469,5804.77,-817,-65.44,2139780,171396.38,1540,2419,1.24,0,0,0
1326,台化         ,20131114,-61,-4.85,72408,5799.88,-1223,-97.96,2138159,171266.54,796,2024,1.24,0,61,0
1326,台化         ,20131115,-4,-0.33,72404,5966.09,570,46.97,2138170,176185.21,1284,629,1.24,0,4,0
1326,台化         ,20131118,466,39.05,72870,6106.51,918,76.93,2138984,179246.86,1525,1040,1.24,766,300,0.01
1326,台化         ,20131119,-237,-19.65,72633,6021.28,99,8.21,2138306,177265.57,1219,1178,1.24,0,237,0
1326,台化         ,20131120,83,6.77,72716,5933.63,-248,-20.24,2138058,174465.53,393,1079,1.24,300,217,0
1326,台化         ,20131121,-35,-2.84,72681,5887.16,-1665,-134.87,2136187,173031.15,1167,2833,1.24,0,35,0
1326,台化         ,20131122,-80,-6.56,72601,5953.28,-1064,-87.25,2134957,175066.47,366,1179,1.24,51,131,0
1326,台化         ,20131125,-55,-4.47,72546,5927.01,607,49.59,2135342,174457.44,725,296,1.24,149,204,0
1326,台化         ,20131126,-330,-27.13,72216,5936.16,-17,-1.4,2135345,175525.36,2291,2099,1.23,0,330,0
1326,台化         ,20131127,-130,-10.79,72086,5983.14,629,52.21,2135974,177285.84,1423,714,1.23,0,130,0
1326,台化         ,20131128,88,7.33,72174,6033.75,1794,149.98,2137778,178718.24,2496,750,1.23,88,0,0
1326,台化         ,20131129,-65,-5.42,72109,6013.89,1248,104.08,2138304,178334.55,1934,705,1.23,0,65,0
1326,台化         ,20131202,0,0,72109,6021.1,746,62.29,2139120,178616.52,862,46,1.23,0,0,0
1326,台化         ,20131203,-160,-13.2,71949,5935.79,331,27.31,2139493,176508.17,962,429,1.23,0,160,0
1326,台化         ,20131204,-161,-13.41,71788,5979.94,1645,137.03,2141237,178365.04,2731,826,1.22,0,161,0
1326,台化         ,20131205,-100,-8.3,71688,5950.1,935,77.61,2142167,177799.86,2236,1206,1.22,0,100,0
1326,台化         ,20131206,24,2.01,71712,5995.12,1907,159.43,2144128,179249.1,2879,943,1.22,24,0,0
1326,台化         ,20131209,266,22.66,71978,6132.53,5092,433.84,2148960,183091.39,5047,497,1.23,266,0,0
1326,台化         ,20131210,0,0,71978,6168.51,2648,226.93,2151737,184403.86,3230,437,1.23,0,0,0
1326,台化         ,20131211,830,71.05,72808,6232.36,2757,236,2154883,184457.98,2577,261,1.24,830,0,0.01
1326,台化         ,20131212,-2,-0.17,72806,6115.7,670,56.28,2155300,181045.2,1448,1029,1.24,0,2,0
1326,台化         ,20131213,75,6.37,72881,6187.6,1663,141.19,2157345,183158.59,2834,864,1.24,76,1,0
1326,台化         ,20131216,-903,-74.95,71978,5974.17,-1416,-117.53,2156915,179023.95,1561,2050,1.23,0,903,0.01
1326,台化         ,20131217,-196,-16.27,71782,5957.91,-33,-2.74,2156934,179025.52,2170,1955,1.22,0,196,0
1326,台化         ,20131218,-661,-55.19,71121,5938.6,574,47.93,2157867,180181.89,2183,1154,1.21,0,661,0.01
1326,台化         ,20131219,0,0,71121,6045.29,2726,231.71,2160783,183666.56,3452,536,1.21,0,0,0
1326,台化         ,20131220,75,6.26,71196,5937.75,-615,-51.29,2160037,180147.09,3872,4692,1.21,75,0,0
1326,台化         ,20131223,-233,-19.69,70963,5996.37,853,72.08,2160851,182591.91,2825,1828,1.21,0,233,0
1326,台化         ,20131224,-295,-24.72,70668,5921.98,151,12.65,2161066,181097.33,1076,577,1.21,0,295,0
1326,台化         ,20131225,-17,-1.44,70651,5970.01,150,12.68,2161248,182625.46,278,79,1.21,0,17,0
1326,台化         ,20131226,-232,-19.42,70419,5894.07,-245,-20.51,2160950,180871.52,79,145,1.2,0,232,0
1326,台化         ,20131227,17,1.42,70436,5902.54,1610,134.92,2161534,181136.55,2002,473,1.2,17,0,0
1326,台化         ,20131230,237,20.12,70673,6000.14,2183,185.34,2163649,183693.8,2085,257,1.21,240,3,0
1326,台化         ,20131231,-8,-0.67,69391,5828.84,1229,103.24,2163738,181753.99,1447,395,1.18,0,8,0
1326,台化         ,20140102,-89,-7.4,69302,5759,562,46.7,2164300,179853.33,998,429,1.18,16,105,0
1326,台化         ,20140103,-1282,-106.02,68020,5625.25,25,2.07,2164380,178994.23,2740,1220,1.16,0,1282,0.01
1326,台化         ,20140106,-337,-27.87,67683,5597.38,268,22.16,2164648,179016.39,2226,1534,1.15,0,337,0
1326,台化         ,20140107,-542,-44.39,67141,5498.85,522,42.75,2165764,177376.07,2385,1299,1.15,0,542,0
1326,台化         ,20140108,-34,-2.78,67107,5482.64,159,12.99,2165923,176955.91,1552,1437,1.14,76,110,0
1326,台化         ,20140109,-360,-29.59,66747,5486.6,624,51.29,2166547,178090.16,2189,1095,1.14,0,360,0
1326,台化         ,20140110,-330,-26.79,66417,5399.7,-1098,-89.27,2165449,176051,800,1591,1.13,0,330,0
1326,台化         ,20140113,-100,-8.16,66317,5411.47,847,69.12,2166296,176769.75,1504,529,1.13,0,100,0
1326,台化         ,20140114,-105,-8.48,66212,5349.93,-794,-64.16,2165502,174972.56,457,1160,1.13,2,107,0
1326,台化         ,20140115,-229,-18.5,65983,5331.43,-537,-43.39,2165286,174955.11,1042,1312,1.13,0,229,0
1326,台化         ,20140116,-76,-6.1,65907,5292.33,-700,-56.21,2164807,173834,837,1598,1.12,0,76,0
1326,台化         ,20140117,-320,-25.7,65587,5266.64,27,2.17,2164834,173836.17,1200,824,1.12,0,320,0
1326,台化         ,20140120,-37,-3,65550,5309.55,113,9.15,2164947,175360.71,1193,1057,1.12,0,37,0
1326,台化         ,20140121,-459,-36.89,65091,5226.81,68,5.46,2165016,173850.78,2009,1480,1.11,85,544,0.01
1326,台化         ,20140122,-535,-42.96,64556,5183.85,372,29.87,2165224,173867.49,2529,1651,1.1,0,535,0
1326,台化         ,20140123,-124,-10.06,64432,5225.44,1167,94.64,2166391,175694.31,2684,1336,1.1,52,176,0
1326,台化         ,20140124,-16,-1.3,64416,5249.9,307,25.02,2166699,176585.97,2093,1795,1.1,0,16,0
1326,台化         ,20140127,-166,-13.18,64250,5101.45,-3696,-293.46,2162414,171695.67,3258,6594,1.1,0,166,0
1326,台化         ,20140205,0,0,64250,4870.15,-8386,-635.66,2154028,163275.32,3157,11666,1.1,0,0,0
1326,台化         ,20140206,-1285,-96.5,62965,4728.67,-6648,-499.26,2147160,161251.72,2073,7476,1.07,0,1285,0.01
1326,台化         ,20140207,174,13.22,63139,4798.56,-2687,-204.21,2144473,162979.95,2297,5022,1.08,284,110,0
1326,台化         ,20140210,-163,-12.36,62976,4773.58,-1692,-128.25,2142734,162419.24,488,2027,1.07,0,163,0
1326,台化         ,20140211,-88,-6.79,62888,4854.95,170,13.12,2142934,165434.5,1156,831,1.07,0,88,0
1326,台化         ,20140212,-59,-4.55,62829,4844.12,-1170,-90.21,2141748,165128.77,601,1729,1.07,0,59,0
1326,台化         ,20140213,-195,-14.99,62634,4804.03,-441,-33.82,2141357,164242.08,373,569,1.07,0,195,0
1326,台化         ,20140214,-360,-28.04,62274,4851.14,1827,142.32,2143149,166951.31,3047,895,1.06,0,360,0
1326,台化         ,20140217,-728,-56.71,61546,4794.43,-1194,-93.01,2141931,166856.42,897,1386,1.05,0,728,0.01
1326,台化         ,20140218,-1419,-109.97,60127,4659.84,-385,-29.84,2141542,165969.51,1835,844,1.03,0,1419,0.01
1326,台化         ,20140219,-149,-11.6,59978,4666.29,928,72.2,2142473,166684.4,1271,153,1.02,9,158,0
1326,台化         ,20140220,-165,-12.71,59813,4605.6,-180,-13.86,2142335,164959.8,491,464,1.02,0,165,0
1326,台化         ,20140221,10,0.78,59823,4690.12,2184,171.23,2144680,168142.91,2851,681,1.02,10,0,0
1326,台化         ,20140224,-288,-22.46,59535,4643.73,226,17.63,2144891,167301.5,908,410,1.02,0,288,0
1326,台化         ,20140225,-183,-14.29,59352,4647.26,424,33.2,2145289,167976.13,1218,643,1.01,0,183,0
1326,台化         ,20140226,-532,-41.28,58820,4564.43,-290,-22.5,2145000,166452,2691,2495,1,0,532,0
1326,台化         ,20140227,-120,-9.25,58700,4525.77,-121,-9.33,2144840,165367.16,2030,2017,1,0,120,0
1326,台化         ,20140303,-737,-56.03,57963,4405.19,-3315,-251.94,2142029,162794.2,2340,4679,0.99,0,737,0.01
1326,台化         ,20140304,-168,-12.6,57795,4346.18,-2255,-169.58,2140021,160929.58,520,2591,0.99,0,168,0
1326,台化         ,20140305,-1588,-118.78,56207,4204.28,-3054,-228.44,2136909,159840.79,590,2114,0.96,0,1588,0.01
1326,台化         ,20140306,-2466,-182.73,53741,3982.21,-2627,-194.66,2134392,158158.45,1495,1546,0.92,0,2466,0.02
1326,台化         ,20140307,-653,-48.71,53088,3960.36,770,57.44,2135671,159321.06,2576,997,0.91,0,653,0.01
1326,台化         ,20140310,-780,-58.14,52308,3896.95,-1203,-89.62,2134548,159023.83,883,1226,0.89,0,780,0.01
1326,台化         ,20140311,-890,-66.33,51418,3830.64,-456,-33.97,2134096,158990.15,2050,1612,0.88,0,890,0.01
1326,台化         ,20140312,-504,-37.3,50914,3767.64,-2054,-152,2132732,157822.17,702,1817,0.87,0,504,0
1326,台化         ,20140313,-30,-2.21,50884,3739.97,-4690,-344.72,2128326,156431.96,2137,6617,0.87,0,30,0
1326,台化         ,20140314,-5,-0.36,50879,3663.29,-6555,-471.96,2121845,152772.84,794,7271,0.87,0,5,0
1326,台化         ,20140317,-119,-8.47,50760,3614.11,-4057,-288.86,2118247,150819.19,1411,5390,0.87,0,119,0
1326,台化         ,20140318,-85,-6.12,50675,3648.6,-1202,-86.54,2117109,152431.85,3838,4991,0.86,0,85,0
1326,台化         ,20140319,-75,-5.4,50600,3643.2,-2824,-203.33,2113814,152194.61,585,3328,0.86,0,75,0
1326,台化         ,20140320,-110,-7.82,50490,3589.84,-4930,-350.52,2108937,149945.42,1846,6613,0.86,0,110,0
1326,台化         ,20140321,-838,-58.83,49652,3485.57,-4141,-290.7,2105340,147794.87,2933,6265,0.85,0,838,0.01
1326,台化         ,20140324,-53,-3.81,49599,3541.37,-37,-2.64,2105386,150324.56,2065,1976,0.85,0,53,0
1326,台化         ,20140325,-100,-7.28,49499,3603.53,185,13.47,2105611,153288.48,2365,2040,0.84,0,100,0
1326,台化         ,20140326,0,0,49499,3549.08,-2567,-184.05,2103594,150827.69,924,3497,0.84,0,0,0
1326,台化         ,20140327,0,0,49499,3643.13,1855,136.53,2106047,155005.06,4885,2947,0.84,0,0,0
1326,台化         ,20140328,-218,-16.06,49281,3636.94,690,50.92,2106816,155483.02,2784,1769,0.84,0,218,0
1326,台化         ,20140331,0,0,44694,3289.48,-1027,-75.59,2101752,154688.95,1883,3046,0.76,0,0,0
1326,台化         ,20140401,-54,-3.96,44640,3276.58,-1352,-99.24,2101433,154245.18,1569,2737,0.76,0,54,0
1326,台化         ,20140402,-46,-3.39,44594,3282.12,204,15.01,2102431,154738.92,1943,1760,0.76,0,46,0
1326,台化         ,20140403,-83,-6.08,44511,3262.66,-991,-72.64,2102250,154094.93,1364,2286,0.76,0,83,0
1326,台化         ,20140407,-22,-1.61,44489,3252.15,-240,-17.54,2101276,153603.28,2066,2258,0.76,0,22,0
1326,台化         ,20140408,0,0,44489,3252.15,-538,-39.33,2100718,153562.49,1934,2493,0.76,0,0,0
1326,台化         ,20140409,0,0,44489,3287.74,1363,100.73,2102590,155381.4,2885,1481,0.76,0,0,0
1326,台化         ,20140410,13,0.97,44502,3288.7,-752,-55.57,2102247,155356.05,1096,1857,0.76,13,0,0
1326,台化         ,20140411,0,0,44502,3293.15,835,61.79,2103255,155640.87,1606,678,0.76,0,0,0
1326,台化         ,20140414,0,0,44502,3288.7,-246,-18.18,2102980,155410.22,1467,1742,0.76,0,0,0
1326,台化         ,20140415,14,1.04,44516,3307.54,320,23.78,2102405,156208.69,2123,1786,0.76,14,0,0
1326,台化         ,20140416,-1,-0.07,44515,3285.21,-1132,-83.54,2101684,155104.28,2253,2973,0.76,0,1,0
1326,台化         ,20140417,-287,-21.21,44228,3268.45,-975,-72.05,2099843,155178.4,786,1440,0.75,0,287,0
1326,台化         ,20140418,-266,-19.71,43962,3257.58,425,31.49,2100262,155629.41,1287,602,0.75,0,266,0
1326,台化         ,20140421,0,0,43962,3240,-39,-2.87,2100266,154789.6,238,234,0.75,2,2,0
1326,台化         ,20140422,-3,-0.22,43959,3209.01,-825,-60.23,2100337,153324.6,662,1514,0.75,0,3,0
1326,台化         ,20140423,0,0,43959,3204.61,-930,-67.8,2098479,152979.12,662,1600,0.75,0,0,0
1326,台化         ,20140424,-40,-2.9,43919,3179.74,-538,-38.95,2097957,151892.09,835,1317,0.75,0,40,0
1326,台化         ,20140425,-50,-3.6,43869,3154.18,1245,89.52,2100075,150995.39,1980,483,0.75,0,50,0
1326,台化         ,20140428,-102,-7.38,43767,3168.73,650,47.06,2100681,152089.3,1794,1086,0.75,0,102,0
1326,台化         ,20140429,0,0,43767,3164.35,131,9.47,2100726,151882.49,1184,974,0.75,0,0,0
1326,台化         ,20140430,-161,-11.75,43606,3183.24,2039,148.85,2102939,153514.55,6646,4287,0.74,0,161,0
1326,台化         ,20140502,0,0,43606,3152.71,-1306,-94.42,2101665,151950.38,1158,2482,0.74,0,0,0
1326,台化         ,20140505,0,0,43606,3139.63,-1407,-101.3,2100243,151217.5,32,1452,0.74,0,0,0
1326,台化         ,20140506,-645,-46.18,42961,3076.01,-2575,-184.37,2097838,150205.2,236,1940,0.73,164,809,0.01
1326,台化         ,20140507,-1,-0.07,42960,3054.46,-3197,-227.31,2094780,148938.86,286,3389,0.73,0,1,0
1326,台化         ,20140508,0,0,42960,3097.42,-604,-43.55,2094321,151000.54,1499,2044,0.73,0,0,0
1326,台化         ,20140509,-1,-0.07,42959,3050.09,-2343,-166.35,2089910,148383.61,568,2713,0.73,0,1,0
1326,台化         ,20140512,0,0,42959,3037.2,-1316,-93.04,2088772,147676.18,317,1460,0.73,0,0,0
1326,台化         ,20140513,-1,-0.07,42958,3054.31,516,36.69,2089576,148568.85,1326,790,0.73,0,1,0
1326,台化         ,20140514,0,0,42958,3088.68,793,57.02,2090223,150287.03,2653,2016,0.73,0,0,0
1326,台化         ,20140515,-71,-5.07,42887,3062.13,-1299,-92.75,2089010,149155.31,848,2176,0.73,1,72,0
1326,台化         ,20140516,-325,-23.08,42562,3021.9,-1322,-93.86,2087709,148227.34,911,1887,0.73,0,325,0
1326,台化         ,20140519,-118,-8.47,42444,3055.97,717,51.62,2088466,150369.55,1400,515,0.72,0,118,0
1326,台化         ,20140520,0,0,42444,3026.26,151,10.77,2088568,148914.9,870,778,0.72,0,0,0
1326,台化         ,20140521,0,0,42444,3038.99,-702,-50.26,2087868,149491.35,634,1334,0.72,0,0,0
1326,台化         ,20140522,0,0,42444,3072.95,1222,88.47,2088908,151236.94,1459,419,0.72,0,0,0
1326,台化         ,20140523,0,0,42444,3098.41,499,36.43,2089479,152531.97,1593,1104,0.72,0,0,0
1326,台化         ,20140526,-32,-2.34,42412,3096.08,-256,-18.69,2089215,152512.7,163,395,0.72,0,32,0
1326,台化         ,20140527,-55,-4.02,42357,3092.06,-128,-9.34,2089002,152497.15,326,399,0.72,0,55,0
1326,台化         ,20140528,-2,-0.15,42355,3121.56,1000,73.7,2089959,154029.98,2198,1239,0.72,0,2,0
1326,台化         ,20140529,106,7.79,42461,3120.88,525,38.59,2090543,153654.91,1443,969,0.72,106,0,0
1326,台化         ,20140530,-380,-27.35,42081,3025.62,-1664,-119.64,2088824,150186.45,3700,5039,0.72,0,380,0
1326,台化         ,20140603,0,0,42081,3076.12,912,66.67,2089744,152760.29,1818,1947,0.72,0,0,0
1326,台化         ,20140604,372,27.12,42453,3094.82,-887,-64.66,2088857,152277.68,504,1762,0.72,372,0,0
1326,台化         ,20140605,0,0,42453,3086.33,-1670,-121.41,2087043,151728.03,675,2898,0.72,0,0,0
1326,台化         ,20140606,-2,-0.15,42451,3077.7,-484,-35.09,2086492,151270.67,393,925,0.72,0,2,0
1326,台化         ,20140609,2,0.15,42453,3082.09,45,3.27,2086519,151481.28,491,459,0.72,2,0,0
1326,台化         ,20140610,-9,-0.66,42444,3089.92,1662,120.99,2088212,152021.83,1967,489,0.72,0,9,0
1326,台化         ,20140611,613,44.57,43057,3130.24,411,29.88,2088881,151861.65,957,1296,0.73,627,14,0.01
1326,台化         ,20140612,-35,-2.53,43022,3110.49,747,54.01,2089628,151080.1,1308,541,0.73,0,35,0
1326,台化         ,20140613,-13,-0.94,43009,3122.45,49,3.56,2089638,151707.72,874,812,0.73,0,13,0
1326,台化         ,20140616,-21,-1.53,42988,3129.53,49,3.57,2088037,152009.09,736,655,0.73,0,21,0
1326,台化         ,20140617,0,0,42988,3138.12,959,70.01,2082468,152020.16,1287,428,0.73,0,0,0
1326,台化         ,20140618,334,24.66,43322,3201.5,3956,292.35,2084413,154038.12,5433,786,0.74,357,23,0
1326,台化         ,20140619,0,0,43322,3223.16,444,33.03,2082103,154908.46,1059,486,0.74,0,0,0
1326,台化         ,20140620,-276,-20.48,43046,3194.01,-713,-52.9,2077931,154182.48,1409,1859,0.73,0,276,0
1326,台化         ,20140623,50,3.75,43096,3227.89,1197,89.66,2077830,155629.47,1514,292,0.74,50,0,0
1326,台化         ,20140624,-8,-0.6,43088,3248.84,575,43.36,2074600,156424.84,1862,1212,0.74,0,8,0
1326,台化         ,20140625,173,12.92,43261,3231.6,-1361,-101.67,2073239,154870.95,967,2591,0.74,177,4,0
1326,台化         ,20140626,100,7.54,43361,3269.42,844,63.64,2074074,156385.18,1599,940,0.74,111,11,0
1326,台化         ,20140627,-1239,-93.42,42122,3176,-878,-66.2,2072203,156244.11,1371,1001,0.72,115,1354,0.01
1326,台化         ,20140630,-21,-1.59,59239,4478.47,132,9.98,2089472,157964.08,902,807,1.01,0,21,0
1326,台化         ,20140701,130,9.95,59369,4541.73,1865,142.67,2091282,159983.07,1987,337,1.01,130,0,0
1326,台化         ,20140702,-1,-0.08,59368,4511.97,235,17.86,2091518,158955.37,1124,1743,1.01,0,1,0
1326,台化         ,20140703,-47,-3.52,59321,4437.21,-424,-31.72,2084700,155935.56,1063,1454,1.01,0,47,0
1326,台化         ,20140704,0,0,59321,4259.25,-2116,-151.93,2082503,149523.72,947,1860,1.01,0,0,0
1326,台化         ,20140707,0,0,59321,4247.38,261,18.69,2082764,149125.9,1455,1118,1.01,0,0,0
1326,台化         ,20140708,-15,-1.07,59306,4246.31,597,42.75,2083361,149168.65,633,144,1.01,0,15,0
1326,台化         ,20140709,0,0,59306,4240.38,273,19.52,2083634,148979.83,532,189,1.01,0,0,0
1326,台化         ,20140710,0,0,59306,4240.38,61,4.36,2083402,148963.24,1529,1557,1.01,0,0,0
1326,台化         ,20140711,0,0,59306,4240.38,1513,108.18,2085013,149078.43,2010,539,1.01,0,0,0
1326,台化         ,20140714,0,0,59306,4210.73,-1052,-74.69,2084028,147965.99,876,1926,1.01,0,0,0
1326,台化         ,20140715,-220,-15.69,59086,4212.83,-568,-40.5,2083508,148554.12,1253,768,1.01,0,220,0
1326,台化         ,20140716,0,0,59086,4189.2,453,32.12,2084113,147763.61,1438,730,1.01,0,0,0
1326,台化         ,20140717,22,1.57,59108,4220.31,1257,89.75,2091874,149359.8,2003,745,1.01,22,0,0
1326,台化         ,20140718,0,0,59108,4249.87,854,61.4,2092733,150467.5,1376,502,1.01,0,0,0
1326,台化         ,20140721,0,0,59108,4255.78,474,34.13,2093086,150702.19,869,406,1.01,0,0,0
1326,台化         ,20140722,39,2.83,59147,4288.16,1564,113.39,2094692,151865.17,2536,1105,1.01,39,0,0
1326,台化         ,20140724,427,30.87,59574,4307.2,88,6.36,2094741,151449.77,719,1028,1.02,427,0,0
1326,台化         ,20140725,518,37.71,60092,4374.7,2418,176.03,2096992,152661.02,2397,477,1.03,518,0,0
1326,台化         ,20140728,0,0,60092,4428.78,2316,170.69,2099357,154722.61,2574,296,1.03,0,0,0
1326,台化         ,20140729,5,0.37,60097,4441.17,3088,228.2,2102444,155370.61,3794,874,1.03,5,0,0
1326,台化         ,20140730,41,3.06,60138,4486.29,2649,197.62,2105103,157040.68,3639,1080,1.03,43,2,0
1326,台化         ,20140731,39,2.86,60177,4410.97,-301,-22.06,2103695,154200.84,2016,2316,1.03,39,0,0
1326,台化         ,20140801,94,6.82,60271,4375.67,581,42.18,2104245,152768.19,906,455,1.03,94,0,0
1326,台化         ,20140804,-200,-14.46,60071,4343.13,-801,-57.91,2103299,152068.52,1592,2201,1.02,0,200,0
1326,台化         ,20140805,665,47.22,60736,4312.26,-3964,-281.44,2099347,149053.64,613,5026,1.04,665,0,0.01
1326,台化         ,20140806,7,0.5,60743,4343.12,545,38.97,2099737,150131.2,1850,1198,1.04,7,0,0
1326,台化         ,20140807,33,2.37,60776,4369.79,-556,-39.98,2099281,150938.3,656,1181,1.04,33,0,0
1326,台化         ,20140808,44,3.13,60820,4330.38,-602,-42.86,2100255,149538.16,679,1315,1.04,44,0,0
1326,台化         ,20140811,15,1.08,60835,4361.87,-65,-4.66,2100190,150583.62,286,366,1.04,15,0,0
1326,台化         ,20140812,12,0.87,60847,4393.15,-241,-17.4,2099872,151610.76,1197,1330,1.04,12,0,0
1326,台化         ,20140813,8,0.59,60855,4454.59,1337,97.87,2101316,153816.33,1865,429,1.04,8,0,0
1326,台化         ,20140814,20,1.45,60875,4419.53,-1042,-75.65,2101085,152538.77,691,1579,1.04,20,0,0
1326,台化         ,20140815,8,0.58,60883,4432.28,186,13.54,2101241,152970.34,584,445,1.04,8,0,0
1326,台化         ,20140818,2,0.14,60885,4383.72,-129,-9.29,2103251,151434.07,307,410,1.04,2,0,0
1326,台化         ,20140819,7,0.51,60892,4469.47,1370,100.56,2104738,154487.77,2170,691,1.04,7,0,0
1326,台化         ,20140820,146,10.79,61038,4510.71,1350,99.77,2106420,155664.44,1859,507,1.04,146,0,0
1326,台化         ,20140821,-59,-4.36,60979,4506.35,268,19.81,2106748,155688.68,723,336,1.04,4,63,0
1326,台化         ,20140822,0,0,60979,4567.33,3050,228.45,2109712,158017.43,4150,1139,1.04,0,0,0
1326,台化         ,20140825,0,0,60979,4573.43,-72,-5.4,2109570,158217.75,923,1023,1.04,0,0,0
1326,台化         ,20140826,2,0.15,60981,4573.58,697,52.28,2110221,158266.58,1603,954,1.04,2,0,0
1326,台化         ,20140827,2,0.15,60983,4622.51,2647,200.64,2112761,160147.28,3414,784,1.04,2,0,0
1326,台化         ,20140828,34,2.58,61017,4625.09,666,50.48,2117129,160478.38,1738,1134,1.04,44,10,0
1326,台化         ,20140829,2,0.15,61019,4539.81,-82,-6.1,2120057,157732.24,2118,2179,1.04,2,0,0
1326,台化         ,20140901,0,0,61019,4545.92,790,58.86,2120847,158003.1,1846,1075,1.04,0,0,0
1326,台化         ,20140902,0,0,61019,4515.41,-59,-4.37,2120924,156948.38,1315,1304,1.04,0,0,0
1326,台化         ,20140903,17,1.26,61036,4522.77,472,34.98,2128905,157751.86,1809,1317,1.04,17,0,0
1326,台化         ,20140904,398,29.57,61434,4564.55,696,51.71,2129588,158228.39,1499,1150,1.05,398,0,0
1326,台化         ,20140905,16,1.18,61450,4547.3,373,27.6,2130328,157644.27,706,369,1.05,16,0,0
1326,台化         ,20140909,0,0,61450,4547.3,466,34.48,2130676,157670.02,824,361,1.05,0,0,0
1326,台化         ,20140910,-141,-10.11,61309,4395.86,-2065,-148.06,2130390,152748.96,857,2019,1.05,0,141,0
1326,台化         ,20140911,-165,-11.8,61144,4371.8,-531,-37.97,2129863,152285.2,602,964,1.04,29,194,0
1326,台化         ,20140912,23,1.64,61167,4373.44,-899,-64.28,2128975,152221.71,563,1474,1.04,23,0,0
1326,台化         ,20140915,5,0.36,61172,4373.8,371,26.53,2129046,152226.79,1180,814,1.04,5,0,0
1326,台化         ,20140916,12,0.86,61184,4362.42,123,8.77,2129159,151809.04,1268,1168,1.04,12,0,0
1326,台化         ,20140917,11,0.79,61195,4393.8,633,45.45,2128919,152856.38,2971,2486,1.04,11,0,0
1326,台化         ,20140918,0,0,61195,4381.56,-220,-15.75,2128587,152406.83,648,869,1.04,0,0,0
1326,台化         ,20140919,-14,-0.96,61181,4343.85,-1360,-96.56,2126959,151014.09,1488,2856,1.04,2,15,0
1326,台化         ,20140922,24,1.74,61205,4363.92,-300,-21.39,2126855,151644.76,2275,2584,1.04,24,0,0
1326,台化         ,20140923,-4,-0.28,61201,4314.67,-687,-48.43,2125653,149858.54,1280,2110,1.04,3,7,0
1326,台化         ,20140924,4,0.28,61205,4345.56,384,27.26,2125850,150935.35,1624,1320,1.04,4,0,0
1326,台化         ,20140925,0,0,61205,4339.43,-806,-57.15,2126866,150794.8,1025,1752,1.04,0,0,0
1326,台化         ,20140926,0,0,61205,4345.56,78,5.54,2127533,151054.84,1414,1335,1.04,0,0,0
1326,台化         ,20140929,0,0,61205,4290.47,-1894,-132.77,2126521,149069.12,2678,4572,1.04,0,0,0
1326,台化         ,20140930,29,2.04,41841,2941.42,-315,-22.14,2106282,148071.62,2377,2769,0.71,29,0,0
1326,台化         ,20141001,0,0,41841,2920.5,-1606,-112.1,2104597,146900.87,1510,3049,0.71,0,0,0
1326,台化         ,20141002,1,0.07,41842,2891.28,-1513,-104.55,2103111,145324.97,1646,3175,0.71,1,0,0
1326,台化         ,20141003,0,0,41842,2916.39,199,13.87,2103386,146606,1463,1169,0.71,0,0,0
1326,台化         ,20141006,8,0.55,41850,2879.28,-1045,-71.9,2103497,144720.59,1473,2459,0.71,8,0,0
1326,台化         ,20141007,-298,-20.32,41552,2833.85,-703,-47.94,2102807,143411.44,1366,1758,0.71,2,300,0
1326,台化         ,20141008,-694,-46.91,40858,2762,-672,-45.43,2102179,142107.3,2278,2265,0.7,2,696,0.01
1326,台化         ,20141009,0,0,40858,2806.94,2021,138.84,2104295,144565.07,2890,885,0.7,0,0,0
1326,台化         ,20141013,0,0,40858,2778.34,1217,82.76,2105421,143168.63,2839,1729,0.7,0,0,0
1326,台化         ,20141014,-1399,-95.41,39459,2691.1,-1393,-95,2104031,143494.91,1941,1931,0.67,1,1400,0.01
1326,台化         ,20141015,6,0.4,39465,2659.94,-1254,-84.52,2102987,141741.32,3356,4434,0.67,6,0,0
1326,台化         ,20141016,-581,-38.85,38884,2601.34,-1324,-88.58,2101719,140605,1798,2540,0.66,0,581,0
1326,台化         ,20141017,4,0.26,38888,2535.5,-2924,-190.64,2098559,136826.05,5903,8870,0.66,4,0,0
1326,台化         ,20141020,0,0,38888,2578.27,1015,67.29,2099656,139207.19,2129,1042,0.66,0,0,0
1326,台化         ,20141021,9,0.6,38897,2598.32,-437,-29.19,2099065,140217.54,1557,1998,0.66,9,0,0
1326,台化         ,20141022,0,0,38897,2645,-706,-48.01,2098700,142711.6,1413,2104,0.66,0,0,0
1326,台化         ,20141023,14,0.95,38911,2642.06,-309,-20.98,2098579,142493.51,1273,1596,0.66,14,0,0
1326,台化         ,20141024,0,0,38911,2645.95,-1142,-77.66,2097413,142624.08,1551,2695,0.66,0,0,0
1326,台化         ,20141027,-1,-0.07,38910,2657.55,356,24.31,2097751,143276.39,1775,1452,0.66,0,1,0
1326,台化         ,20141028,0,0,38910,2712.03,2378,165.75,2099879,146361.57,4828,2479,0.66,0,0,0
1326,台化         ,20141029,3,0.21,38913,2731.69,1157,81.22,2101023,147491.81,2134,994,0.66,3,0,0
1326,台化         ,20141030,203,14.35,39116,2765.5,1423,100.61,2102578,148652.26,1912,716,0.67,203,0,0
1326,台化         ,20141031,24,1.7,39140,2771.11,69,4.89,2102926,148887.16,2298,2255,0.67,28,4,0
1326,台化         ,20141103,-45,-3.16,39095,2748.38,81,5.69,2102851,147830.43,1294,1271,0.67,0,45,0
1326,台化         ,20141104,0,0,39095,2736.65,313,21.91,2103145,147220.15,1696,1386,0.67,0,0,0
1326,台化         ,20141105,0,0,39095,2744.47,141,9.9,2102886,147622.6,1658,1515,0.67,0,0,0
1326,台化         ,20141106,0,0,39095,2721.01,560,38.98,2103746,146420.72,1036,674,0.67,0,0,0
1326,台化         ,20141107,-20,-1.37,39075,2680.55,-482,-33.07,2103264,144283.91,892,1368,0.67,0,20,0
1326,台化         ,20141110,0,0,39075,2754.79,2699,190.28,2105976,148471.31,3708,1098,0.67,0,0,0
1326,台化         ,20141111,25,1.75,39100,2740.91,373,26.15,2106374,147656.82,1561,1223,0.67,25,0,0
1326,台化         ,20141112,12,0.82,39112,2679.17,-1677,-114.87,2104721,144173.39,639,2303,0.67,12,0,0
1326,台化         ,20141113,0,0,39112,2694.82,-213,-14.68,2104504,145000.33,1684,1885,0.67,0,0,0
1326,台化         ,20141114,0,0,39112,2679.17,-858,-58.77,2103706,144103.86,614,1416,0.67,0,0,0
1326,台化         ,20141117,-38,-2.55,39074,2625.77,-1013,-68.07,2102720,141302.78,629,1606,0.67,0,38,0
1326,台化         ,20141118,0,0,39074,2676.57,1442,98.78,2104027,144125.85,1725,421,0.67,0,0,0
1326,台化         ,20141119,0,0,39074,2692.2,1248,85.99,2106884,145164.31,4330,3165,0.67,0,0,0
1326,台化         ,20141120,5,0.35,39079,2719.9,1164,81.01,2108004,146717.08,1389,242,0.67,5,0,0
1326,台化         ,20141121,0,0,39079,2719.9,113,7.86,2108320,146739.07,925,801,0.67,0,0,0
1326,台化         ,20141124,0,0,39079,2727.71,701,48.93,2109105,147215.53,1251,647,0.67,0,0,0
1326,台化         ,20141125,0,0,39079,2715.99,-325,-22.59,2108642,146550.62,2307,2606,0.67,1,1,0
1326,台化         ,20141126,0,0,39079,2712.08,-663,-46.01,2107789,146280.56,328,1011,0.67,0,0,0
1326,台化         ,20141127,-1,-0.07,39078,2739.37,1319,92.46,2109111,147848.68,1530,215,0.67,0,1,0
1326,台化         ,20141128,0,0,39078,2735.46,224,15.68,2108480,147593.6,1340,1110,0.67,0,0,0
1326,台化         ,20141201,0,0,39078,2665.12,-1730,-117.99,2107217,143712.2,582,2350,0.67,0,0,0
1326,台化         ,20141202,0,0,39078,2637.77,-2752,-185.76,2104896,142080.48,581,3339,0.67,0,0,0
1326,台化         ,20141203,-11,-0.75,39067,2660.46,-795,-54.14,2104088,143288.39,949,1733,0.67,0,11,0
1326,台化         ,20141204,0,0,39067,2687.81,-58,-3.99,2104317,144777.01,1558,1579,0.67,0,0,0
1326,台化         ,20141205,-313,-21.25,38754,2631.4,-1577,-107.08,2102748,142776.59,478,1726,0.66,0,313,0
1326,台化         ,20141208,-84,-5.65,38670,2602.49,-870,-58.55,2101857,141454.98,681,1463,0.66,0,84,0
1326,台化         ,20141209,0,0,38670,2579.29,-1593,-106.25,2100256,140087.08,514,2115,0.66,0,0,0
1326,台化         ,20141210,-10,-0.66,38660,2567.02,-1948,-129.35,2098308,139327.65,769,2707,0.66,0,10,0
1326,台化         ,20141211,-3,-0.17,38657,2543.63,-1959,-128.9,2096566,137954.04,301,2257,0.66,0,3,0
1326,台化         ,20141212,0,0,38657,2520.44,-1987,-129.55,2094657,136571.64,149,2133,0.66,0,0,0
1326,台化         ,20141215,0,0,38657,2458.59,-2453,-156.01,2092200,133063.92,325,2782,0.66,0,0,0
1326,台化         ,20141216,7,0.45,38664,2482.23,-1217,-78.13,2090644,134219.34,1134,2579,0.66,7,0,0
1326,台化         ,20141217,0,0,38664,2397.17,-4310,-267.22,2086137,129340.49,1283,5690,0.66,0,0,0
1326,台化         ,20141218,0,0,38664,2424.23,-1424,-89.28,2085150,130738.91,1162,2567,0.66,0,0,0
1326,台化         ,20141219,204,13.04,38868,2483.67,467,29.84,2085602,133269.97,2194,1893,0.66,205,1,0
1326,台化         ,20141222,-280,-18.06,38588,2488.93,37,2.39,2085461,134512.23,921,708,0.66,50,330,0
1326,台化         ,20141223,0,0,38588,2508.22,356,23.14,2085353,135547.95,814,528,0.66,0,0,0
1326,台化         ,20141224,723,48.51,39311,2637.77,1384,92.87,2086468,140002,1212,777,0.67,723,0,0.01
1326,台化         ,20141225,0,0,39311,2610.25,249,16.53,2086717,138558.01,459,231,0.67,0,0,0
1326,台化         ,20141226,0,0,39311,2633.84,869,58.22,2087436,139858.21,991,122,0.67,0,0,0
1326,台化         ,20141227,0,0,39311,2645.63,45,3.03,2087481,140487.47,0,0,0.67,0,0,0
1326,台化         ,20141229,-8,-0.54,39303,2656.88,1843,124.59,2089412,141244.25,2635,820,0.67,0,8,0
1326,台化         ,20141230,-63,-4.2,39240,2613.38,117,7.79,2089693,139173.55,1260,842,0.67,0,63,0
1326,台化         ,20141231,-1,-0.07,38307,2562.74,407,27.23,2089195,139767.15,994,520,0.65,0,1,0
1326,台化         ,20150105,-505,-33.33,37802,2494.93,-1164,-76.82,2087547,137778.1,1019,1807,0.64,250,755,0.01
1326,台化         ,20150106,-68,-4.32,37734,2396.11,-2864,-181.86,2084808,132385.31,913,3710,0.64,0,68,0
1326,台化         ,20150107,-94,-5.89,37640,2360.03,-1883,-118.06,2082925,130599.4,1765,3755,0.64,0,94,0
1326,台化         ,20150108,657,42.44,38297,2473.99,692,44.7,2083617,134601.66,2436,2685,0.65,757,100,0.01
1326,台化         ,20150109,-1493,-96.3,36804,2373.86,-2670,-172.22,2080747,134208.18,600,1909,0.63,0,1493,0.01
1326,台化         ,20150112,846,55.75,37650,2481.14,1914,126.13,2082661,137247.36,2503,1443,0.64,970,124,0.01
1326,台化         ,20150113,187,12.25,37837,2478.32,762,49.91,2083402,136462.83,2420,1919,0.65,190,3,0
1326,台化         ,20150114,-4,-0.26,37833,2493.19,-212,-13.97,2082084,137209.34,2840,2916,0.65,0,4,0
1326,台化         ,20150115,0,0,37833,2478.06,-1307,-85.61,2080487,136271.9,932,2180,0.65,0,0,0
1326,台化         ,20150116,0,0,37833,2470.49,-2215,-144.64,2078272,135711.16,1532,3634,0.65,0,0,0
1326,台化         ,20150119,217,14.45,38050,2534.13,328,21.84,2078698,138441.29,1121,1063,0.65,217,0,0
1326,台化         ,20150120,424,28.83,38474,2616.23,2208,150.14,2081063,141512.28,3063,1415,0.66,424,0,0
1326,台化         ,20150121,510,35.04,38984,2678.2,1839,126.34,2083144,143111.99,2681,1361,0.67,510,0,0
1326,台化         ,20150122,363,25.05,39347,2714.94,-358,-24.7,2083400,143754.6,1686,2287,0.67,363,0,0
1326,台化         ,20150123,245,17.13,39592,2767.48,422,29.5,2083718,145651.89,2670,2343,0.68,250,5,0
1326,台化         ,20150126,15,1.05,39607,2768.53,-787,-55.01,2083374,145627.84,683,1505,0.68,15,0,0
1326,台化         ,20150127,0,0,39607,2772.49,845,59.15,2084459,145912.13,1611,727,0.68,0,0,0
1326,台化         ,20150128,0,0,39607,2772.49,814,56.98,2085283,145969.81,1391,577,0.68,0,0,0
1326,台化         ,20150129,-36,-2.51,39571,2754.14,-485,-33.76,2084856,145105.98,1680,1904,0.68,0,36,0
1326,台化         ,20150130,-10,-0.68,39561,2682.24,-1114,-75.53,2083104,141234.45,2518,3618,0.67,0,10,0
1326,台化         ,20150202,600,41.7,40161,2791.19,1884,130.94,2085277,144926.75,2192,1018,0.69,600,0,0.01
1326,台化         ,20150203,666,47.69,40827,2923.21,3132,224.25,2088446,149532.73,3128,1620,0.7,666,0,0.01
1326,台化         ,20150204,460,33.63,41287,3018.08,3892,284.51,2092621,152970.6,8768,5401,0.7,460,0,0
1326,台化         ,20150205,0,0,41287,3013.95,-149,-10.88,2092766,152771.92,1316,1218,0.7,0,0,0
1326,台化         ,20150206,-1,-0.07,41286,2989.11,567,41.05,2093457,151566.29,1790,1163,0.7,0,1,0
1326,台化         ,20150209,86,6.18,41372,2974.65,-245,-17.62,2093157,150497.99,418,907,0.71,86,0,0
1326,台化         ,20150210,-476,-33.65,40896,2891.35,-13,-0.92,2093161,147986.48,1463,1014,0.7,0,476,0
1326,台化         ,20150211,140,10,41036,2929.97,1857,132.59,2094221,149527.38,3014,1310,0.7,140,0,0
1326,台化         ,20150212,861,61.13,41897,2974.69,1745,123.9,2095999,148815.93,1602,694,0.71,865,4,0.01
1326,台化         ,20150213,-12,-0.85,41885,2978.02,807,57.38,2096369,149051.84,1778,932,0.71,0,12,0
1326,台化         ,20150224,0,0,41885,2986.4,2000,142.6,2098390,149615.21,3483,1466,0.71,0,0,0
1326,台化         ,20150225,239,17.06,42124,3007.65,2458,175.5,2101174,150023.82,2812,514,0.72,270,31,0
1326,台化         ,20150226,-7,-0.49,42117,2965.04,546,38.44,2100810,147897.02,2848,2339,0.72,0,7,0
1326,台化         ,20150302,80,5.55,42197,2928.47,121,8.4,2101289,145829.46,2087,1645,0.72,80,0,0
1326,台化         ,20150303,-2,-0.14,42195,2915.67,1195,82.57,2102775,145301.75,2563,1085,0.72,0,2,0
1326,台化         ,20150304,-27,-1.91,42168,2981.28,1591,112.48,2104868,148814.17,2622,665,0.72,0,27,0
1326,台化         ,20150305,-5,-0.35,42163,2930.33,-456,-31.69,2104670,146274.57,1325,1687,0.72,0,5,0
1326,台化         ,20150306,540,38.34,42703,3031.91,-526,-37.35,2104503,149419.71,2904,3970,0.73,540,0,0
1326,台化         ,20150309,-166,-11.57,42537,2964.83,-1653,-115.21,2102548,146547.6,258,1773,0.73,235,401,0.01
1326,台化         ,20150310,-1,-0.07,42536,2934.98,-1710,-117.99,2100868,144959.89,1095,2784,0.73,0,1,0
1326,台化         ,20150311,-1,-0.07,42535,2913.65,-1686,-115.49,2099210,143795.89,984,2658,0.73,0,1,0
1326,台化         ,20150312,-390,-27.16,42145,2937.51,-115,-8.02,2099103,146307.48,4663,4386,0.72,0,390,0
1326,台化         ,20150313,0,0,42145,2920.65,-749,-51.91,2098549,145429.45,1951,2700,0.72,0,0,0
1326,台化         ,20150316,237,16.38,42382,2928.6,-838,-57.91,2097741,144953.9,573,1628,0.72,237,0,0
1326,台化         ,20150317,-3,-0.21,42379,2924.15,-170,-11.73,2097855,144752,1566,1598,0.72,0,3,0
1326,台化         ,20150318,0,0,42379,2966.53,1073,75.11,2099604,146972.28,2806,1666,0.72,0,0,0
1326,台化         ,20150319,-2,-0.14,42377,3008.77,2071,147.04,2101699,149220.63,2598,551,0.72,0,2,0
1326,台化         ,20150320,-34,-2.41,42343,3006.35,390,27.69,2102776,149297.1,2505,2083,0.72,2,36,0
1326,台化         ,20150323,-2,-0.14,42341,3014.68,449,31.97,2103290,149754.25,1620,1104,0.72,0,2,0
1326,台化         ,20150324,-4,-0.29,42337,3027.1,1702,121.69,2104881,150498.99,2659,959,0.72,0,4,0
1326,台化         ,20150325,-46,-3.22,42291,2960.37,-741,-51.87,2104566,147319.62,1052,1608,0.72,0,46,0
1326,台化         ,20150326,0,0,42291,2998.43,1595,113.09,2106175,149327.81,2333,724,0.72,0,0,0
1326,台化         ,20150327,-65,-4.6,42226,2989.6,97,6.87,2106241,149121.86,1763,1632,0.72,0,65,0
1326,台化         ,20150330,0,0,42226,2998.05,1174,83.35,2107478,149630.94,2128,891,0.72,0,0,0
1326,台化         ,20150331,-1,-0.07,38872,2791.01,2236,160.54,2106358,151236.5,3437,1203,0.66,0,1,0
1326,台化         ,20150401,-115,-8,38757,2697.49,-2156,-150.06,2104118,146446.61,771,2750,0.66,0,115,0
1326,台化         ,20150402,0,0,38757,2751.75,2018,143.28,2106031,149528.2,2668,638,0.66,0,0,0
1326,台化         ,20150407,709,51.9,39466,2888.91,4754,347.99,2110711,154504.05,4206,397,0.67,709,0,0.01
1326,台化         ,20150408,2459,182.95,41925,3119.22,8344,620.79,2119049,157657.25,7217,1997,0.72,2477,18,0.02
1326,台化         ,20150409,381,28.16,42306,3126.41,845,62.45,2119894,156660.17,2597,1724,0.72,436,55,0
1326,台化         ,20150410,165,12.21,42471,3142.85,858,63.49,2120903,156946.82,1865,1167,0.72,165,0,0
1326,台化         ,20150413,270,20.25,42741,3205.58,2225,166.88,2123230,159242.25,2636,877,0.73,325,55,0
1326,台化         ,20150414,64,4.75,42805,3176.13,123,9.13,2123331,157551.16,3600,3745,0.73,68,4,0
1326,台化         ,20150415,25,1.85,42830,3169.42,-2323,-171.9,2121008,156954.59,2576,4971,0.73,68,43,0
1326,台化         ,20150416,786,59.81,43616,3319.18,3750,285.38,2124858,161701.69,4296,1593,0.74,786,0,0.01
1326,台化         ,20150417,1204,90.9,44820,3383.91,472,35.64,2125710,160491.11,1214,1998,0.76,1204,0,0.01
1326,台化         ,20150420,298,22.71,45118,3437.99,987,75.21,2126587,162045.93,1603,938,0.77,332,34,0
1326,台化         ,20150421,487,37.26,45605,3488.78,-640,-48.96,2125714,162617.12,608,1797,0.78,487,0,0
1326,台化         ,20150422,254,19.33,45859,3489.87,88,6.7,2125051,161716.38,3685,3616,0.78,329,75,0
1326,台化         ,20150423,286,22.39,46145,3613.15,6171,483.19,2131982,166934.19,6742,1064,0.79,286,0,0
1326,台化         ,20150424,579,45.97,46724,3709.89,7503,595.74,2139457,169872.89,7321,748,0.8,581,2,0
1326,台化         ,20150427,750,59.7,47474,3778.93,6150,489.54,2145540,170784.98,6277,746,0.81,750,0,0.01
1326,台化         ,20150428,282,22.62,47756,3830.03,2802,224.72,2148092,172276.98,4560,1846,0.81,284,2,0
1326,台化         ,20150429,462,36.73,48218,3833.33,2458,195.41,2150539,170967.85,3103,1635,0.82,471,9,0
1326,台化         ,20150430,608,47.55,48826,3818.19,2090,163.44,2150660,168181.61,5498,4200,0.83,610,2,0.01
1326,台化         ,20150504,57,4.48,48883,3842.2,624,49.05,2151305,169092.57,1799,1238,0.83,57,0,0
1326,台化         ,20150505,-2,-0.16,48881,3866.49,862,68.18,2152198,170238.86,1440,714,0.83,0,2,0
1326,台化         ,20150506,0,0,48881,3910.48,2353,188.24,2153807,172304.56,3471,1175,0.83,0,0,0
1326,台化         ,20150507,0,0,48881,3798.05,-360,-27.97,2153426,167321.2,1642,2021,0.83,0,0,0
1326,台化         ,20150508,187,14.36,49068,3768.42,-490,-37.63,2152935,165345.41,1383,2138,0.84,187,0,0
1326,台化         ,20150511,-222,-17.16,48846,3775.8,1219,94.23,2154155,166516.18,2130,408,0.83,263,485,0.01
1326,台化         ,20150512,1119,88.18,49965,3937.24,3800,299.44,2158116,170059.54,3897,1014,0.85,1119,0,0.01
1326,台化         ,20150513,174,13.62,50139,3925.88,540,42.28,2158685,169025.04,988,626,0.86,244,70,0
1326,台化         ,20150514,3,0.23,50142,3870.96,-133,-10.27,2158929,166669.32,2908,2647,0.86,3,0,0
1326,台化         ,20150515,-511,-38.84,49631,3771.96,-679,-51.6,2158658,164058.01,1482,1253,0.85,105,616,0.01
1326,台化         ,20150518,426,33.19,50057,3899.44,574,44.71,2159345,168212.98,1294,837,0.85,655,229,0.01
1326,台化         ,20150519,332,26.33,50389,3995.85,1213,96.19,2162377,171476.5,1935,933,0.86,332,0,0
1326,台化         ,20150520,99,7.8,50488,3978.45,985,77.62,2163605,170492.07,3784,2464,0.86,178,79,0
1326,台化         ,20150521,-836,-64.37,49652,3823.2,-2402,-184.95,2161485,166434.35,2728,4064,0.85,96,932,0.01
1326,台化         ,20150522,-174,-13.64,49478,3879.08,1675,131.32,2163191,169594.17,3067,1177,0.84,67,241,0
1326,台化         ,20150525,-95,-7.32,49383,3807.43,-714,-55.05,2162539,166731.76,825,1392,0.84,0,95,0
1326,台化         ,20150526,0,0,49383,3822.24,463,35.84,2162955,167412.72,925,453,0.84,0,0,0
1326,台化         ,20150527,-205,-15.72,49178,3771.95,608,46.63,2163529,165942.67,1725,912,0.84,0,205,0
1326,台化         ,20150528,-761,-57.53,48417,3660.33,-1359,-102.74,2162147,163458.31,2818,3433,0.83,23,784,0.01
1326,台化         ,20150529,-585,-43.93,47832,3592.18,839,63.01,2163001,162441.38,5784,4355,0.82,0,585,0
1326,台化         ,20150601,-946,-70,46886,3469.56,-955,-70.67,2162056,159992.14,2577,2586,0.8,80,1026,0.01
1326,台化         ,20150602,-640,-48.06,46246,3473.07,43,3.23,2162211,162382.05,2895,2120,0.79,0,640,0.01
1326,台化         ,20150603,74,5.49,46320,3436.94,-819,-60.77,2161440,160378.85,1536,2405,0.79,74,0,0
1326,台化         ,20150604,-77,-5.54,46243,3338.74,-2016,-145.56,2160384,155979.72,2268,4185,0.79,0,77,0
1326,台化         ,20150605,-4,-0.29,46239,3343.08,-1850,-133.76,2158450,156055.94,1826,3653,0.79,0,4,0
1326,台化         ,20150608,0,0,46239,3430.93,-1240,-92.01,2157146,160060.23,1128,2368,0.79,0,0,0
1326,台化         ,20150609,0,0,46239,3430.93,-122,-9.05,2156720,160028.62,1481,1594,0.79,0,0,0
1326,台化         ,20150610,22,1.64,46261,3455.7,-339,-25.32,2156077,161058.95,1675,2040,0.79,32,10,0
1326,台化         ,20150611,32,2.4,46293,3476.6,-1036,-77.8,2154800,161825.48,1627,2689,0.79,127,95,0
1326,台化         ,20150612,-304,-22.31,45989,3375.59,-1967,-144.38,2151519,157921.49,1244,2907,0.78,0,304,0
1326,台化         ,20150615,-113,-8.17,45876,3316.83,-1075,-77.72,2147613,155272.42,671,1633,0.78,0,113,0
1326,台化         ,20150616,-79,-5.7,45797,3301.96,-140,-10.09,2147450,154831.15,2589,2650,0.78,0,79,0
1326,台化         ,20150617,-159,-11.3,45638,3244.86,-1923,-136.73,2145580,152550.74,3291,5120,0.78,0,159,0
1326,台化         ,20150618,132,9.33,45770,3235.94,-1063,-75.15,2144489,151615.37,2695,3908,0.78,140,8,0
1326,台化         ,20150622,86,6.3,45856,3361.24,1256,92.06,2144618,157200.5,2584,1523,0.78,140,54,0
1326,台化         ,20150623,97,7.08,45953,3354.57,-958,-69.93,2139851,156209.12,940,1982,0.78,97,0,0
1326,台化         ,20150624,-27,-1.99,45926,3380.15,258,18.99,2134203,157077.34,902,614,0.78,12,39,0
1326,台化         ,20150625,-5,-0.37,45921,3411.93,1054,78.31,2130828,158320.52,3200,2197,0.78,0,5,0
1326,台化         ,20150626,-47,-3.46,45874,3376.33,-222,-16.34,2125510,156437.54,1176,1413,0.78,0,47,0
1326,台化         ,20150629,-76,-5.49,45798,3306.62,-588,-42.45,2123217,153296.27,672,1209,0.78,0,76,0
1326,台化         ,20150630,-535,-39.7,70977,5266.49,706,52.39,2149485,159491.79,2886,2095,1.21,70,605,0.01
1326,台化         ,20150701,187,13.84,71164,5266.14,210,15.54,2149184,159039.62,2091,2040,1.21,187,0,0
1326,台化         ,20150702,43,3.18,71207,5269.32,-931,-68.89,2148268,158971.83,1474,2468,1.21,43,0,0
1326,台化         ,20150703,92,6.79,71299,5261.87,-836,-61.7,2147395,158477.75,532,1474,1.22,92,0,0
1326,台化         ,20150706,0,0,71299,5204.83,-186,-13.58,2147219,156746.99,1481,1671,1.22,0,0,0
1326,台化         ,20150707,-1200,-87,70099,5082.18,-323,-23.42,2146906,155650.69,1976,1139,1.2,0,1200,0.01
1326,台化         ,20150708,136,9.47,70235,4888.36,-2440,-169.82,2145102,149299.1,2062,4746,1.2,136,0,0
1326,台化         ,20150709,-8,-0.56,70227,4887.8,-1001,-69.67,2144122,149230.89,2130,3213,1.2,1,9,0
1326,台化         ,20150713,-367,-26.35,69860,5015.95,174,12.49,2144986,154009.99,2954,2467,1.19,0,367,0
1326,台化         ,20150714,-32,-2.32,69828,5069.51,616,44.72,2146273,155819.42,2647,1855,1.19,21,53,0
1326,台化         ,20150715,-172,-12.81,69656,5189.37,1991,148.33,2148318,160049.69,3724,1594,1.19,28,200,0
1326,台化         ,20150716,8,0.6,69664,5217.83,1979,148.23,2149812,161020.92,3144,1171,1.19,257,249,0
1326,台化         ,20150717,-53,-3.94,69611,5172.1,996,74,2150778,159802.81,2319,1271,1.19,37,90,0
1326,台化         ,20150720,0,0,69611,5158.18,2357,174.65,2153175,159550.27,2546,829,1.19,0,0,0
1326,台化         ,20150721,2,0.15,69613,5123.52,1452,106.87,2154627,158580.55,2590,622,1.19,2,0,0
1326,台化         ,20150722,-89,-6.54,69524,5110.01,1550,113.93,2156069,158471.07,2585,952,1.19,0,89,0
1326,台化         ,20150723,287,21.38,69811,5200.92,2470,184.02,2158516,160809.44,2931,759,1.19,287,0,0
1326,台化         ,20150724,138,10.35,69949,5246.18,396,29.7,2159444,161958.3,2003,1549,1.19,138,0,0
1326,台化         ,20150727,0,0,69949,5141.25,715,52.55,2160131,158769.63,1667,1076,1.19,0,0,0
1326,台化         ,20150728,44,3.22,69993,5123.49,965,70.64,2161654,158233.07,3084,2399,1.19,79,35,0
1326,台化         ,20150729,27,2,70020,5188.48,296,21.93,2163721,160331.73,2017,1675,1.19,27,0,0
1326,台化         ,20150730,18,1.31,70038,5105.77,68,4.96,2164528,157794.09,1616,1558,1.19,18,0,0
1326,台化         ,20150731,143,10.7,70181,5249.54,1266,94.7,2165486,161978.35,4879,3255,1.2,143,0,0
1326,台化         ,20150803,103,7.62,70284,5201.02,168,12.43,2167774,160415.28,2047,1913,1.2,103,0,0
1326,台化         ,20150804,-140,-10.33,70144,5176.63,1021,75.35,2169016,160073.38,2040,1544,1.2,60,200,0
1326,台化         ,20150805,-197,-14.5,69947,5148.1,2210,162.66,2170951,159781.99,3133,974,1.19,48,245,0
1326,台化         ,20150806,53,3.87,70000,5110,787,57.45,2171266,158502.42,1342,777,1.19,53,0,0
1326,台化         ,20150807,81,5.87,70081,5080.87,395,28.64,2171661,157445.42,1632,1435,1.2,81,0,0
1326,台化         ,20150810,-851,-61.7,69230,5019.18,732,53.07,2173014,157543.52,1765,349,1.18,152,1003,0.01
1326,台化         ,20150811,70,4.9,69300,4851,-1248,-87.36,2172307,152061.49,2681,3849,1.18,329,259,0.01
1326,台化         ,20150812,-275,-19.55,69025,4907.68,1880,133.67,2174169,154583.42,2961,1115,1.18,175,450,0.01
1326,台化         ,20150813,-1081,-75.13,67944,4722.11,-217,-15.08,2173357,151048.31,3796,3039,1.16,29,1110,0.01
1326,台化         ,20150814,30,2.08,67974,4710.6,373,25.85,2177637,150910.24,1453,1091,1.16,30,0,0
1326,台化         ,20150817,2,0.14,67976,4649.56,519,35.5,2180148,149122.12,1613,1151,1.16,2,0,0
1326,台化         ,20150818,-321,-21.67,67655,4566.71,253,17.08,2180338,147172.82,2841,2081,1.15,1,322,0
1326,台化         ,20150819,-130,-8.81,67525,4578.2,380,25.76,2180720,147852.82,3435,2967,1.15,1,131,0
1326,台化         ,20150820,-27,-1.78,67498,4454.87,-2699,-178.13,2178769,143798.75,1438,4050,1.15,2,29,0
1326,台化         ,20150821,106,6.87,67604,4380.74,167,10.82,2179100,141205.68,3581,3500,1.15,254,148,0
1326,台化         ,20150824,-187,-11.61,67417,4186.6,-3887,-241.38,2175584,135103.77,2845,6552,1.15,10,197,0
1326,台化         ,20150825,-244,-15.28,67173,4198.31,-1646,-102.88,2174274,135892.13,2333,3747,1.15,198,442,0.01
1326,台化         ,20150826,-296,-18.74,66877,4233.31,-1620,-102.55,2172508,137519.76,2899,4154,1.14,147,443,0.01
1326,台化         ,20150827,48,3.09,66925,4309.97,-3106,-200.03,2169404,139709.62,2192,5169,1.14,95,47,0
1326,台化         ,20150828,-83,-5.77,66842,4645.52,163,11.33,2169344,150769.41,3459,2433,1.14,155,238,0
1326,台化         ,20150831,-110,-7.66,66732,4644.55,-1942,-135.16,2167265,150841.64,5120,6710,1.14,203,313,0
1326,台化         ,20150901,-156,-10.64,66576,4540.48,-2288,-156.04,2165576,147692.28,2833,4786,1.14,99,255,0
1326,台化         ,20150902,44,2.98,66620,4516.84,-1642,-111.33,2164088,146725.17,2145,3770,1.14,136,92,0
1326,台化         ,20150903,36,2.43,66656,4505.95,-1349,-91.19,2161097,146090.16,1475,2758,1.14,104,68,0
1326,台化         ,20150904,-84,-5.64,66572,4466.98,-2028,-136.08,2161241,145019.27,1381,3190,1.14,30,114,0
1326,台化         ,20150907,-2,-0.14,66570,4500.13,-707,-47.79,2160939,146079.48,955,1669,1.14,66,68,0
1326,台化         ,20150908,12,0.81,66582,4467.65,-2040,-136.88,2158883,144861.05,305,2312,1.14,12,0,0
1326,台化         ,20150909,-34,-2.34,66548,4578.5,1027,70.66,2159790,148593.55,4646,3718,1.14,70,104,0
1326,台化         ,20150910,110,7.63,66658,4626.07,470,32.62,2160341,149927.67,1428,1004,1.14,110,0,0
1326,台化         ,20150911,21,1.45,66679,4600.85,-688,-47.47,2159594,149011.99,535,1253,1.14,21,0,0
1326,台化         ,20150914,6,0.41,66685,4601.27,-1332,-91.91,2158304,148922.98,831,2110,1.14,6,0,0
1326,台化         ,20150915,241,16.51,66926,4584.43,-274,-18.77,2158256,147840.54,1058,1582,1.14,241,0,0
1326,台化         ,20150916,308,21.19,67234,4625.7,940,64.67,2159223,148554.54,2376,1717,1.15,395,87,0
1326,台化         ,20150917,-15,-1.06,67219,4759.11,2245,158.95,2161312,153020.89,3918,1727,1.15,20,35,0
1326,台化         ,20150918,-310,-21.98,66909,4743.85,109,7.73,2161441,153246.17,3085,2646,1.14,10,320,0
1326,台化         ,20150921,118,8.2,67027,4658.38,-1298,-90.21,2160249,150137.31,1469,2779,1.14,118,0,0
1326,台化         ,20150922,-408,-28.35,66619,4623.36,-533,-36.99,2159714,149884.15,762,888,1.14,3,411,0
1326,台化         ,20150923,250,17.25,66869,4613.96,-1522,-105.02,2159091,148977.28,1401,3162,1.14,250,0,0
1326,台化         ,20150924,60,4.14,66929,4618.1,-1385,-95.57,2157744,148884.34,434,1866,1.14,60,0,0
1326,台化         ,20150925,1,0.07,66930,4571.32,-1016,-69.39,2157548,147360.53,1010,2016,1.14,1,0,0
1326,台化         ,20150930,-331,-22.11,46390,3098.85,-3748,-250.37,2133522,142519.27,4298,7816,0.79,0,331,0
1326,台化         ,20151001,16,1.1,46406,3197.37,38,2.62,2133126,146972.38,2751,2776,0.79,47,31,0
1326,台化         ,20151002,49,3.39,46455,3214.69,-772,-53.42,2132369,147559.93,1544,2359,0.79,49,0,0
1326,台化         ,20151005,-27,-1.87,46428,3217.46,175,12.13,2132674,147794.31,1808,1572,0.79,0,27,0
1326,台化         ,20151006,802,56.54,47230,3329.72,1100,77.55,2133950,150443.48,2232,2094,0.81,802,0,0.01
1326,台化         ,20151007,364,26.1,47594,3412.49,858,61.52,2135234,153096.28,4227,3839,0.81,364,0,0
1326,台化         ,20151008,128,9.31,47722,3469.39,803,58.38,2136157,155298.61,1869,1119,0.81,128,0,0
1326,台化         ,20151012,1393,106.56,49115,3757.3,4190,320.54,2140443,163743.89,5019,2710,0.84,1393,0,0.01
1326,台化         ,20151013,360,26.64,49475,3661.15,572,42.33,2141081,158439.99,3712,3322,0.84,360,0,0
1326,台化         ,20151014,0,0,49475,3641.36,760,55.94,2142124,157660.33,2172,1309,0.84,0,0,0
1326,台化         ,20151015,412,30.65,49887,3711.59,1755,130.57,2143442,159472.08,3106,1693,0.85,412,0,0
1326,台化         ,20151016,7,0.53,49894,3781.97,2181,165.32,2146298,162689.39,5772,3504,0.85,7,0,0
1326,台化         ,20151019,300,22.5,50194,3764.55,1844,138.3,2148588,161144.1,2918,1373,0.86,300,0,0
1326,台化         ,20151020,65,4.92,50259,3804.61,2103,159.2,2149863,162744.63,4665,2638,0.86,65,0,0
1326,台化         ,20151021,80,5.96,50339,3750.26,44,3.28,2150809,160235.27,1573,1684,0.86,80,0,0
1326,台化         ,20151022,34,2.53,50373,3747.75,880,65.47,2151587,160078.07,2105,1260,0.86,34,0,0
1326,台化         ,20151023,-66,-4.95,50307,3773.03,1679,125.93,2153660,161524.5,3341,1591,0.86,0,66,0
1326,台化         ,20151026,0,0,50307,3778.06,1384,103.94,2155120,161849.51,2679,1302,0.86,0,0,0
1326,台化         ,20151027,18,1.36,50325,3809.6,1152,87.21,2155926,163203.6,2883,1744,0.86,18,0,0
1326,台化         ,20151028,0,0,50325,3809.6,128,9.69,2155650,163182.7,1674,1509,0.86,0,0,0
1326,台化         ,20151029,-1,-0.08,50324,3794.43,-733,-55.27,2154997,162486.77,1330,2092,0.86,0,1,0
1326,台化         ,20151030,36,2.68,50360,3751.82,924,68.84,2155416,160578.49,3470,2630,0.86,36,0,0
1326,台化         ,20151102,7,0.53,50367,3797.67,186,14.02,2155678,162538.12,1226,981,0.86,7,0,0
1326,台化         ,20151103,-568,-43.22,49799,3789.7,1650,125.56,2157058,164152.11,3424,1313,0.85,7,575,0
1326,台化         ,20151104,58,4.44,49857,3819.05,3140,240.52,2160207,165471.86,4544,1533,0.85,60,2,0
1326,台化         ,20151105,-158,-12.01,49699,3777.12,-42,-3.19,2160175,164173.3,1445,1223,0.85,1,159,0
1326,台化         ,20151106,-100,-7.4,49599,3670.33,-3484,-257.82,2156709,159596.47,1595,4955,0.85,0,100,0
1326,台化         ,20151109,-70,-5.12,49529,3625.52,932,68.22,2157535,157931.56,2007,1017,0.85,30,100,0
1326,台化         ,20151110,-245,-17.44,49284,3509.02,-2605,-185.48,2154760,153418.91,2095,4457,0.84,0,245,0
1326,台化         ,20151111,148,10.63,49432,3549.22,-1294,-92.91,2153391,154613.47,1471,2859,0.84,148,0,0
1326,台化         ,20151112,6,0.43,49438,3534.82,-433,-30.96,2153046,153942.79,2044,2451,0.84,68,62,0
1326,台化         ,20151113,-283,-19.81,49155,3440.85,-1790,-125.3,2151075,150575.25,2495,3978,0.84,18,301,0
1326,台化         ,20151116,0,0,49155,3416.27,-2017,-140.18,2148989,149354.74,932,2962,0.84,0,0,0
1326,台化         ,20151117,-198,-13.9,48957,3436.78,-275,-19.31,2148390,150816.98,1191,1269,0.84,0,198,0
1326,台化         ,20151118,-210,-14.6,48747,3387.92,-1501,-104.32,2146828,149204.55,1894,3321,0.83,0,210,0
1326,台化         ,20151119,110,7.91,48857,3512.82,641,46.09,2147469,154403.02,2273,1729,0.83,110,0,0
1326,台化         ,20151120,0,0,48857,3439.53,-924,-65.05,2146559,151117.75,1085,2015,0.83,0,0,0
1326,台化         ,20151123,-1,-0.07,48856,3512.75,112,8.05,2146640,154343.42,1327,1212,0.83,0,1,0
1326,台化         ,20151124,0,0,48856,3483.43,359,25.6,2147013,153082.03,1902,1536,0.83,0,0,0
1326,台化         ,20151125,0,0,48856,3532.29,1663,120.23,2148686,155350,2837,1176,0.83,0,0,0
1326,台化         ,20151126,0,0,48856,3605.57,1935,142.8,2150631,158716.57,3373,1457,0.83,0,0,0
1326,台化         ,20151127,-10,-0.72,48846,3497.37,-1088,-77.9,2149517,153905.42,1248,2307,0.83,0,10,0
1326,台化         ,20151130,-430,-30.36,48416,3418.17,-3924,-277.03,2145551,151475.9,8539,12054,0.83,0,430,0
1326,台化         ,20151201,0,0,48416,3481.11,2177,156.53,2147730,154421.79,3316,1137,0.83,0,0,0
1326,台化         ,20151202,-609,-43.24,47807,3394.3,334,23.71,2148095,152514.75,1836,905,0.82,66,675,0.01
1326,台化         ,20151203,-86,-6.11,47721,3388.19,1142,81.08,2149071,152584.04,2187,943,0.81,0,86,0
1326,台化         ,20151204,0,0,47721,3359.56,-811,-57.09,2148249,151236.73,1967,2779,0.81,0,0,0
1326,台化         ,20151207,-250,-17.5,47471,3322.97,696,48.72,2148953,150426.71,1712,768,0.81,0,250,0
1326,台化         ,20151208,-772,-52.88,46699,3198.88,-1924,-131.79,2147029,147071.49,1494,2647,0.8,0,772,0.01
1326,台化         ,20151209,-60,-4.09,46639,3176.12,-994,-67.69,2146032,146144.78,1476,2413,0.8,0,60,0
1326,台化         ,20151210,0,0,46639,3148.13,-2472,-166.86,2143780,144705.15,2342,4815,0.8,0,0,0
1326,台化         ,20151211,-75,-5.08,46564,3152.38,-1374,-93.02,2142433,145042.71,3036,4349,0.79,0,75,0
1326,台化         ,20151214,-62,-4.15,46502,3110.98,-62,-4.15,2142374,143324.82,2403,2385,0.79,0,62,0
1326,台化         ,20151215,0,0,46502,3134.23,-719,-48.46,2141766,144355.03,1591,2199,0.79,0,0,0
1326,台化         ,20151216,-2,-0.14,46500,3185.25,16,1.1,2141787,146712.41,1194,1171,0.79,0,2,0
1326,台化         ,20151217,-37,-2.56,46463,3219.89,526,36.45,2142338,148464.02,1980,1402,0.79,0,37,0
1326,台化         ,20151218,-19,-1.3,46444,3181.41,1516,103.85,2143865,146854.75,4074,2538,0.79,0,19,0
1326,台化         ,20151221,-210,-14.28,46234,3143.91,1661,112.95,2145353,145884,3281,1410,0.79,0,210,0
1326,台化         ,20151222,214,14.87,46448,3228.14,1044,72.56,2145883,149138.87,1990,1161,0.79,214,0,0
1326,台化         ,20151223,537,37.48,46985,3279.55,779,54.37,2146690,149838.96,838,610,0.8,612,75,0.01
1326,台化         ,20151224,301,21.07,47286,3310.02,515,36.05,2147211,150304.77,1208,1014,0.81,301,0,0
1326,台化         ,20151225,95,6.65,47381,3316.67,200,14,2147436,150320.52,636,532,0.81,95,0,0
1326,台化         ,20151228,78,5.48,47459,3336.37,1047,73.6,2148532,151041.8,1633,664,0.81,96,18,0
1326,台化         ,20151229,-36,-2.51,47423,3305.38,-264,-18.4,2147737,149697.27,678,905,0.81,0,36,0
1326,台化         ,20151230,138,9.73,47561,3353.05,-1289,-90.87,2146685,151341.29,1034,2380,0.81,138,0,0
1326,台化         ,20151231,-2360,-174.64,46158,3415.69,-2406,-178.04,2145974,158802.08,2393,2430,0.79,0,2360,0.02
1326,台化         ,20160104,749,51.08,46907,3199.06,-5127,-349.66,2141088,146022.2,424,6376,0.8,749,0,0.01
1326,台化         ,20160105,-197,-13.49,46710,3199.64,368,25.21,2141466,146690.42,1922,1347,0.8,0,197,0
1326,台化         ,20160106,-1756,-120.46,44954,3083.84,39,2.68,2141518,146908.13,4027,2294,0.77,189,1945,0.02
1326,台化         ,20160107,8,0.55,44962,3102.38,-2201,-151.87,2138939,147586.79,2872,5164,0.77,11,3,0
1326,台化         ,20160108,0,0,44962,3061.91,-2524,-171.88,2136120,145469.77,1002,3531,0.77,0,0,0
1326,台化         ,20160111,0,0,44962,3088.89,-3593,-246.84,2132655,146513.4,695,4309,0.77,0,0,0
1326,台化         ,20160112,186,12.96,45148,3146.82,-1592,-110.96,2130537,148498.43,1042,2825,0.77,188,2,0
1326,台化         ,20160113,672,47.31,45820,3225.73,-1104,-77.72,2129576,149922.15,1270,3021,0.78,673,1,0.01
1326,台化         ,20160114,137,9.64,45957,3235.37,-1338,-94.2,2128339,149835.07,1011,2475,0.78,137,0,0
1326,台化         ,20160115,78,5.54,46035,3268.49,-4262,-302.6,2124442,150835.38,657,4886,0.79,111,33,0
1326,台化         ,20160118,-598,-41.95,45437,3185.13,-2389,-167.47,2121982,148750.94,3588,5473,0.78,215,813,0.01
1326,台化         ,20160119,156,10.94,45593,3196.07,-207,-14.51,2120114,148619.99,1145,1494,0.78,200,44,0
1326,台化         ,20160120,-124,-8.58,45469,3146.45,-1680,-116.26,2118433,146595.56,1696,3161,0.78,0,124,0
1326,台化         ,20160121,-10,-0.68,45459,3082.12,-1298,-88,2117135,143541.75,1316,2689,0.78,0,10,0
1326,台化         ,20160122,-273,-18.78,45186,3108.8,1323,91.02,2118721,145768,3163,1475,0.77,0,273,0
1326,台化         ,20160125,76,5.36,45262,3190.97,730,51.47,2119451,149421.3,2293,1659,0.77,80,4,0
1326,台化         ,20160126,0,0,45262,3159.29,-384,-26.8,2119131,147915.34,1054,1399,0.77,0,0,0
1326,台化         ,20160127,0,0,45262,3172.87,927,64.98,2120072,148617.05,1582,647,0.77,0,0,0
1326,台化         ,20160128,0,0,45262,3172.87,1118,78.37,2121178,148694.58,2738,1620,0.77,0,0,0
1326,台化         ,20160129,52,3.71,45314,3235.42,3090,220.63,2124267,151672.66,5202,2170,0.77,52,0,0
1326,台化         ,20160130,112,7.99,45426,3238.87,518,36.93,2124690,151490.4,402,0,0.78,162,50,0
1326,台化         ,20160201,-50,-3.6,45376,3262.53,1057,76,2126069,152864.36,2186,986,0.77,0,50,0
1326,台化         ,20160202,0,0,45376,3262.53,1112,79.95,2127016,152932.45,2649,1534,0.77,0,0,0
1326,台化         ,20160203,0,0,45376,3199.01,-388,-27.35,2126728,149934.32,2124,2511,0.77,0,0,0
1326,台化         ,20160215,0,-0.02,45376,3235.31,836,59.61,2127581,151696.53,4219,3383,0.77,0,0,0
1326,台化         ,20160216,0,0,45376,3248.92,1344,96.23,2129096,152443.27,2602,1305,0.77,0,0,0
1326,台化         ,20160217,1,0.07,45377,3244.46,708,50.62,2129765,152278.2,1258,665,0.77,1,0,0
1326,台化         ,20160218,124,9.03,45501,3312.47,1457,106.07,2131283,155157.4,2624,1290,0.78,124,0,0
1326,台化         ,20160219,0,0,45501,3303.37,756,54.89,2132039,154786.03,1652,893,0.78,0,0,0
1326,台化         ,20160222,0,0,45501,3285.17,428,30.9,2132235,153947.37,1634,1157,0.78,0,0,0
1326,台化         ,20160223,-700,-50.68,44801,3243.59,-64,-4.63,2132494,154392.57,1317,698,0.76,0,700,0.01
1326,台化         ,20160224,-276,-20.15,44525,3250.33,219,15.99,2132821,155695.93,1811,1320,0.76,0,276,0
1326,台化         ,20160225,-193,-14.09,44332,3236.24,181,13.21,2133222,155725.21,1943,1534,0.76,0,193,0
1326,台化         ,20160226,140,10.47,44472,3326.51,1953,146.08,2135500,159735.4,3703,1981,0.76,140,0,0
1326,台化         ,20160301,0,0,44472,3330.95,-539,-40.37,2135134,159921.54,2833,3411,0.76,0,0,0
1326,台化         ,20160302,11,0.84,44483,3362.91,870,65.77,2135710,161459.68,1590,776,0.76,38,27,0
1326,台化         ,20160303,427,32.67,44910,3435.61,1524,116.59,2137456,163515.38,2584,1480,0.77,427,0,0
1326,台化         ,20160304,310,23.9,45220,3486.46,1151,88.74,2138880,164907.65,2659,1881,0.77,310,0,0
1326,台化         ,20160307,80,6.28,45300,3556.05,1085,85.17,2140108,167998.48,2705,1582,0.77,80,0,0
1326,台化         ,20160308,1990,158.4,47290,3764.28,3459,275.34,2143657,170635.1,2559,1399,0.81,1990,0,0.02
1326,台化         ,20160309,38,2.97,47328,3701.05,55,4.3,2143977,167659,1492,1540,0.81,62,24,0
1326,台化         ,20160310,-153,-11.81,47175,3641.91,403,31.11,2144413,165548.68,3078,2558,0.8,0,153,0
1326,台化         ,20160311,392,30.58,47567,3710.23,2605,203.19,2147181,167480.12,3436,1265,0.81,490,98,0.01
1326,台化         ,20160314,450,34.74,48017,3706.91,2662,205.51,2149853,165968.65,2420,538,0.82,450,0,0
1326,台化         ,20160315,179,13.77,48196,3706.27,2694,207.17,2152719,165544.09,3240,685,0.82,229,50,0
1326,台化         ,20160316,-15,-1.16,48181,3724.39,1532,118.42,2154251,166523.6,2417,735,0.82,65,80,0
1326,台化         ,20160317,257,20.05,48438,3778.16,3307,257.95,2157189,168260.74,3864,1208,0.83,277,20,0
1326,台化         ,20160318,54,4.31,48492,3869.66,2373,189.37,2160065,172373.19,7668,5599,0.83,80,26,0
1326,台化         ,20160321,283,22.3,48775,3843.47,-501,-39.48,2159626,170178.53,2525,3275,0.83,323,40,0
1326,台化         ,20160322,55,4.34,48830,3852.69,1107,87.34,2161237,170521.6,2682,1809,0.83,55,0,0
1326,台化         ,20160323,0,0,48830,3852.69,2131,168.14,2163378,170690.52,2830,1184,0.83,0,0,0
1326,台化         ,20160324,-20,-1.59,48810,3890.16,2150,171.36,2165860,172619.04,2315,208,0.83,0,20,0
1326,台化         ,20160325,349,27.43,49159,3863.9,-46,-3.62,2165814,170232.98,199,433,0.84,679,330,0.01
1326,台化         ,20160328,313,24.7,49472,3903.34,1615,127.42,2167940,171050.47,1438,150,0.84,453,140,0.01
1326,台化         ,20160329,75,5.89,49547,3889.44,1269,99.62,2169219,170283.69,1606,320,0.85,76,1,0
1326,台化         ,20160330,89,7.13,49636,3975.84,5100,408.51,2174658,174190.11,5502,634,0.85,135,46,0
1326,台化         ,20160331,1131,90.71,47101,3777.5,5516,442.38,2174432,174389.45,7710,3712,0.8,1131,0,0.01
1326,台化         ,20160401,60,4.87,47161,3824.76,3713,301.12,2178758,176697.27,7312,3583,0.8,60,0,0
1326,台化         ,20160406,-32,-2.52,47129,3709.05,291,22.9,2179192,171502.41,3667,3210,0.8,131,163,0
1326,台化         ,20160407,118,9.27,47247,3713.61,683,53.68,2179944,171343.6,4312,3678,0.81,118,0,0
1326,台化         ,20160408,87,6.97,47334,3791.45,2313,185.27,2182588,174825.3,4851,2724,0.81,97,10,0
1326,台化         ,20160411,0,0,47334,3810.39,141,11.35,2182671,175705.02,1904,1820,0.81,0,0,0
1326,台化         ,20160412,-1,-0.08,47333,3833.97,1978,160.22,2184729,176963.05,3066,1007,0.81,0,1,0
1326,台化         ,20160413,603,49.63,47936,3945.13,7308,601.45,2192031,180404.15,7877,1178,0.82,646,43,0.01
1326,台化         ,20160414,221,18.72,48157,4078.9,11732,993.7,2203653,186649.41,12332,951,0.82,221,0,0
1326,台化         ,20160415,600,50.88,48757,4134.59,3653,309.77,2207085,187160.81,3939,1241,0.83,613,13,0.01
1326,台化         ,20160418,123,10.44,48880,4149.91,2360,200.36,2209455,187582.73,3217,1194,0.83,123,0,0
1326,台化         ,20160419,-37,-3.18,48843,4200.5,7816,672.18,2217271,190685.31,9199,1682,0.83,23,60,0
1326,台化         ,20160420,543,45.88,49386,4173.12,3497,295.5,2220853,187662.08,5953,3488,0.84,543,0,0
1326,台化         ,20160421,400,33.8,49786,4206.92,1806,152.61,2222659,187814.69,1637,723,0.85,400,0,0
1326,台化         ,20160422,-11,-0.93,49775,4186.08,2631,221.27,2225521,187166.32,3389,637,0.85,0,11,0
1326,台化         ,20160425,-1,-0.08,49774,4181.02,1495,125.58,2227017,187069.43,1599,382,0.85,0,1,0
1326,台化         ,20160426,0,0,49774,4166.08,1128,94.41,2228051,186487.87,2885,1519,0.85,0,0,0
1326,台化         ,20160427,0,0,49774,4190.97,1301,109.54,2229352,187711.44,3731,2376,0.85,0,0,0
1326,台化         ,20160428,0,0,49774,4185.99,353,29.69,2229705,187518.19,4817,3423,0.85,0,0,0
1326,台化         ,20160429,158,13.02,49932,4114.4,-791,-65.18,2228749,183648.92,3783,4270,0.85,158,0,0
1326,台化         ,20160503,0,0,49932,4034.51,1474,119.1,2230579,180230.78,4571,2818,0.85,0,0,0
1326,台化         ,20160504,57,4.53,49989,3974.13,1109,88.17,2231770,177425.72,5406,4075,0.85,160,103,0
1326,台化         ,20160505,-153,-12.13,49836,3951.99,339,26.88,2232408,177029.95,3819,3307,0.85,0,153,0
1326,台化         ,20160506,-35,-2.81,49801,4004,1463,117.63,2234190,179628.88,9317,7300,0.85,30,65,0
1326,台化         ,20160509,57,4.58,49858,4003.6,479,38.46,2235847,179538.51,4178,2395,0.85,57,0,0
1326,台化         ,20160510,39,3.15,49897,4006.73,-227,-18.23,2235660,179523.5,2789,2631,0.85,40,1,0
1326,台化         ,20160511,0,0,49897,4156.42,3415,284.47,2240143,186603.91,9328,5059,0.85,0,0,0
1326,台化         ,20160512,0,0,49897,4146.44,160,13.3,2240343,186172.5,3244,2995,0.85,0,0,0
1326,台化         ,20160513,-22,-1.8,49875,4079.78,-103,-8.43,2240310,183257.36,5528,5628,0.85,0,22,0
1326,台化         ,20160516,0,0,49875,4034.89,-209,-16.91,2239883,181206.53,1537,1822,0.85,0,0,0
1326,台化         ,20160517,280,23.13,50155,4142.8,712,58.81,2240590,185072.73,4726,4121,0.86,280,0,0
1326,台化         ,20160518,20,1.68,50175,4214.7,2013,169.09,2242880,188401.92,6978,4833,0.86,20,0,0
1326,台化         ,20160519,-1255,-100.15,48920,3903.82,-3745,-298.85,2238906,178664.7,2548,5266,0.83,10,1265,0.01
1326,台化         ,20160520,-1282,-103.59,47638,3849.15,837,67.63,2243203,181250.8,5213,2904,0.81,36,1318,0.01
1326,台化         ,20160523,-739,-59.56,46899,3780.06,-142,-11.45,2242607,180754.12,2370,1908,0.8,0,739,0.01
1326,台化         ,20160524,-305,-24.86,46594,3797.41,1623,132.27,2244157,182898.8,5224,3368,0.79,25,330,0
1326,台化         ,20160525,-278,-22.6,46316,3765.49,-794,-64.55,2243152,182368.26,1748,2476,0.79,0,278,0
1326,台化         ,20160526,-419,-33.69,45897,3690.12,-150,-12.06,2243002,180337.36,1758,1523,0.78,0,419,0
1326,台化         ,20160527,-75,-6.11,45822,3734.49,1439,117.28,2244482,182925.28,2215,695,0.78,0,75,0
1326,台化         ,20160530,-1153,-94.08,44669,3644.99,1045,85.27,2245484,183231.49,2799,644,0.76,0,1153,0.01
1326,台化         ,20160531,-3,-0.25,44666,3671.55,1329,109.24,2246424,184656.05,7855,6423,0.76,0,3,0
1326,台化         ,20160601,-140,-11.47,44526,3646.68,1503,123.1,2247739,184089.82,3243,1574,0.76,0,140,0
1326,台化         ,20160602,11,0.91,44537,3665.4,2024,166.58,2249541,185137.22,3645,1629,0.76,11,0,0
1326,台化         ,20160603,617,50.59,45154,3702.63,646,52.97,2249621,184468.92,2542,2562,0.77,676,59,0.01
1326,台化         ,20160604,-23,-1.89,45131,3700.74,53,4.35,2249449,184454.82,75,0,0.77,30,53,0
1326,台化         ,20160606,-57,-4.68,45074,3700.58,872,71.59,2250358,184754.39,2363,1375,0.77,0,57,0
1326,台化         ,20160607,-148,-12.51,44926,3796.25,5494,464.24,2255520,190591.44,7833,2083,0.77,0,148,0
1326,台化         ,20160608,77,6.44,45003,3762.25,2447,204.57,2257822,188753.92,5301,3518,0.77,160,83,0
1326,台化         ,20160613,-132,-10.69,44871,3634.55,770,62.37,2258367,182927.73,3506,2354,0.77,0,132,0
1326,台化         ,20160614,-116,-9.4,44755,3625.16,141,11.42,2258240,182917.44,3162,2867,0.76,0,116,0
1326,台化         ,20160615,-50,-4.12,44705,3683.69,2130,175.51,2260070,186229.77,3899,1859,0.76,0,50,0
1326,台化         ,20160616,-469,-37.71,44236,3556.57,-1537,-123.57,2258189,181558.4,1872,3049,0.75,0,469,0
1326,台化         ,20160617,-312,-25.02,43924,3522.7,1470,117.89,2259273,181193.69,3537,1740,0.75,0,312,0
1326,台化         ,20160620,-903,-73.23,43021,3489,1488,120.68,2260761,183347.72,3092,713,0.73,0,903,0.01
1326,台化         ,20160621,-295,-23.92,42726,3465.08,774,62.77,2263500,183569.85,2020,912,0.73,0,295,0
1326,台化         ,20160622,-20,-1.64,42706,3497.62,1542,126.29,2264709,185479.67,2798,1161,0.73,0,20,0
1326,台化         ,20160623,-20,-1.64,42686,3491.71,-15,-1.23,2264720,185254.1,1472,1156,0.73,0,20,0
1326,台化         ,20160624,-201,-15.98,42485,3377.56,-3475,-276.26,2261218,179766.83,1762,5141,0.72,17,218,0
1326,台化         ,20160627,-221,-17.66,42264,3376.89,-1208,-96.52,2260010,180574.8,761,1682,0.72,0,221,0
1326,台化         ,20160628,-139,-11.26,42125,3412.13,920,74.52,2261101,183149.18,3009,1766,0.72,167,306,0
1326,台化         ,20160629,0,0,42125,3407.91,213,17.23,2261143,182926.47,2000,2050,0.72,0,0,0
1326,台化         ,20160630,-134,-10.85,42947,3478.71,1448,117.29,2263532,183346.09,3318,1908,0.73,0,134,0
1326,台化         ,20160701,930,76.45,43877,3606.69,3153,259.18,2266790,186330.14,3821,2044,0.75,930,0,0.01
1326,台化         ,20160704,613,50.39,44490,3657.08,146,12,2266936,186342.14,2027,2668,0.76,627,14,0.01
1326,台化         ,20160705,150,12.32,44640,3664.94,889,72.99,2267721,186179.89,2417,3742,0.76,200,50,0
1326,台化         ,20160706,61,4.75,44701,3477.74,-2443,-190.07,2265278,176238.63,2727,4310,0.76,100,39,0
1326,台化         ,20160707,102,7.94,44803,3485.67,326,25.36,2265604,176263.99,983,762,0.76,102,0,0
1326,台化         ,20160711,-150,-11.88,44653,3536.52,3563,282.19,2269167,179718.03,5200,1418,0.76,30,180,0
1326,台化         ,20160712,836,68.72,45489,3739.2,8276,680.29,2277443,187205.81,10088,1373,0.78,836,0,0.01
1326,台化         ,20160713,6,0.49,45495,3739.69,2549,209.53,2280003,187416.25,4012,1710,0.78,6,0,0
1326,台化         ,20160714,-1,-0.08,45494,3739.61,2157,177.31,2282193,187596.26,3338,1157,0.78,0,1,0
1326,台化         ,20160715,21,1.73,45515,3750.44,4280,352.67,2286560,188412.54,5084,785,0.78,21,0,0
1326,台化         ,20160718,0,0,45515,3773.19,4055,336.16,2292005,190007.21,4079,251,0.78,0,0,0
1326,台化         ,20160719,-322,-26.82,45193,3764.58,6072,505.8,2298133,191434.48,6469,174,0.77,8,330,0
1326,台化         ,20160720,155,12.93,45348,3782.02,5405,450.78,2304776,192218.32,6085,755,0.77,178,23,0
1326,台化         ,20160721,-174,-14.56,45174,3781.06,4075,341.08,2309773,193328,4612,533,0.77,1,175,0
1326,台化         ,20160722,-3,-0.25,45171,3776.3,3170,265.01,2315886,193608.07,4128,867,0.77,64,67,0
1326,台化         ,20160725,171,14.33,45342,3799.66,2499,209.42,2319374,194363.54,3551,1142,0.77,181,10,0
1326,台化         ,20160726,-20,-1.68,45322,3797.98,5468,458.22,2328337,195114.64,5878,386,0.77,80,100,0
1326,台化         ,20160727,-33,-2.77,45289,3804.28,6084,511.06,2334421,196091.36,7131,779,0.77,0,33,0
1326,台化         ,20160728,42,3.55,45331,3830.47,4680,395.46,2339111,197654.88,6249,1401,0.77,42,0,0
1326,台化         ,20160729,245,20.38,45576,3787.37,649,53.93,2338080,194294.45,2395,2382,0.78,325,80,0
1326,台化         ,20160801,-492,-41.03,45084,3760.01,2083,173.72,2339409,195106.71,4311,1729,0.77,8,500,0
1326,台化         ,20160802,-85,-7.13,44999,3775.42,1561,130.97,2340222,196344.63,2516,868,0.77,0,85,0
1326,台化         ,20160803,-128,-10.74,44871,3764.68,1350,113.27,2341599,196460.16,3094,1589,0.77,13,141,0
1326,台化         ,20160804,-705,-59.22,44166,3709.94,342,28.73,2342152,196740.77,3286,2100,0.75,25,730,0.01
1326,台化         ,20160805,-51,-4.26,44115,3688.01,-967,-80.84,2341071,195713.54,2502,3606,0.75,0,51,0
1326,台化         ,20160808,76,6.38,44191,3712.04,1040,87.36,2342229,196747.24,1970,936,0.75,87,11,0
1326,台化         ,20160809,33,2.79,44224,3732.51,1366,115.29,2343598,197799.67,2598,1326,0.75,50,17,0
1326,台化         ,20160810,-37,-3.12,44187,3724.96,-116,-9.78,2343543,197560.67,2331,2610,0.75,35,72,0
1326,台化         ,20160811,24,2.04,44211,3757.94,477,40.55,2343818,199224.53,2863,2405,0.75,26,2,0
1326,台化         ,20160812,25,2.13,44236,3773.33,1509,128.72,2345382,200061.08,3471,2751,0.75,31,6,0
1326,台化         ,20160815,-126,-10.75,44110,3762.58,255,21.75,2345698,200088.04,1787,1362,0.75,26,152,0
1326,台化         ,20160816,-76,-6.46,44034,3742.89,-907,-77.1,2344852,199312.42,2610,3373,0.75,12,88,0
1326,台化         ,20160817,-43,-3.62,43991,3708.44,606,51.09,2345522,197727.5,1680,1047,0.75,2,45,0
1326,台化         ,20160818,-143,-12.04,43848,3692,585,49.26,2346107,197542.21,1571,858,0.75,0,143,0
1326,台化         ,20160819,-129,-10.75,43719,3641.79,-1701,-141.69,2344406,195289.02,765,2342,0.75,0,129,0
1326,台化         ,20160822,-9,-0.74,43710,3614.82,-1478,-122.23,2342917,193759.24,1212,2638,0.75,0,9,0
1326,台化         ,20160823,-1,-0.08,43709,3675.93,742,62.4,2343659,197101.72,1843,764,0.75,0,1,0
1326,台化         ,20160824,-7,-0.58,43702,3649.12,-347,-28.97,2342943,195635.74,604,1071,0.75,0,7,0
1326,台化         ,20160825,-2,-0.17,43700,3631.47,-242,-20.11,2342701,194678.45,1592,1935,0.75,0,2,0
1326,台化         ,20160826,-12,-1,43688,3630.47,604,50.19,2343305,194728.65,1404,722,0.75,0,12,0
1326,台化         ,20160829,0,0,43688,3634.84,-54,-4.49,2343251,194958.48,1356,1303,0.75,0,0,0
1326,台化         ,20160830,0,0,43688,3626.1,-375,-31.13,2342902,194460.87,991,1367,0.75,30,30,0
1326,台化         ,20160831,2,0.16,43690,3600.06,-1355,-111.65,2340654,192869.89,2912,4183,0.75,2,0,0
1326,台化         ,20160901,91,7.32,43781,3519.99,-3050,-245.22,2337672,187948.83,395,3468,0.75,91,0,0
1326,台化         ,20160902,24,1.97,43805,3587.63,588,48.16,2338410,191515.78,2360,1647,0.75,24,0,0
1326,台化         ,20160905,344,28.38,44149,3642.29,471,38.86,2339167,192981.28,979,786,0.75,346,2,0
1326,台化         ,20160906,-45,-3.76,44104,3687.09,1199,100.24,2340543,195669.39,2961,1539,0.75,0,45,0
1326,台化         ,20160907,340,29.04,44444,3795.52,355,30.32,2341329,199949.5,2088,1845,0.76,340,0,0
1326,台化         ,20160908,49,4.19,44493,3804.15,-610,-52.16,2341126,200166.27,1969,2559,0.76,55,6,0
1326,台化         ,20160909,109,9.19,44602,3759.95,-1885,-158.91,2339389,197210.49,839,2685,0.76,109,0,0
1326,台化         ,20160910,22,1.84,44624,3726.1,-723,-60.37,2338884,195296.81,0,527,0.76,22,0,0
1326,台化         ,20160912,-45,-3.67,44579,3633.19,-4477,-364.88,2334464,190258.82,763,5257,0.76,0,45,0
1326,台化         ,20160913,0,0,44579,3646.56,-1850,-151.33,2332901,190831.3,2930,4603,0.76,0,0,0
1326,台化         ,20160914,58,4.67,44637,3593.28,-3972,-319.75,2328998,187484.34,3656,7617,0.76,58,0,0
1326,台化         ,20160919,-200,-16.74,44437,3719.38,606,50.72,2329772,195001.92,2215,1241,0.76,0,200,0
1326,台化         ,20160920,0,0,44437,3701.6,-1350,-112.46,2328418,193957.22,615,1969,0.76,0,0,0
1326,台化         ,20160921,-5,-0.42,44432,3754.5,538,45.46,2328992,196799.82,1578,1000,0.76,0,5,0
1326,台化         ,20160922,3,0.26,44435,3785.86,-761,-64.84,2328284,198369.8,1081,1792,0.76,3,0,0
1326,台化         ,20160923,-20,-1.71,44415,3788.6,-45,-3.84,2328185,198594.18,1993,2093,0.76,0,20,0
1326,台化         ,20160926,177,14.99,44592,3776.94,-251,-21.26,2327939,197176.43,425,848,0.76,200,23,0
1326,台化         ,20160929,0,0,44592,3808.16,2843,242.79,2330768,199047.59,4720,1891,0.76,0,0,0
1326,台化         ,20160930,58,4.87,32739,2759.9,-1796,-151.4,2319220,195510.25,2785,4635,0.56,58,0,0
1326,台化         ,20161003,54,4.6,32793,2793.96,451,38.43,2319673,197636.14,1234,834,0.56,54,0,0
1326,台化         ,20161004,-980,-83.5,31813,2710.47,34,2.9,2319710,197639.29,2450,1433,0.54,0,980,0.01
1326,台化         ,20161005,-5,-0.43,31808,2703.68,-699,-59.42,2319022,197116.87,545,1228,0.54,0,5,0
1326,台化         ,20161006,0,0,31808,2703.68,-493,-41.91,2319043,197118.66,1146,1167,0.54,0,0,0
1326,台化         ,20161007,276,23.63,32084,2746.39,461,39.46,2319099,198514.87,2030,2292,0.55,276,0,0
1326,台化         ,20161011,451,38.61,32535,2785,371,31.76,2319470,198546.63,2584,3250,0.56,451,0,0
1326,台化         ,20161012,230,19.96,32765,2844,1478,128.29,2320864,201451,4665,3830,0.56,230,0,0
1326,台化         ,20161013,551,48.32,33316,2921.81,-421,-36.92,2320485,203506.53,5338,6091,0.57,551,0,0
1326,台化         ,20161014,318,27.89,33634,2949.7,1558,136.64,2322113,203649.31,3582,2692,0.57,318,0,0
1326,台化         ,20161017,922,80.86,34556,3030.56,549,48.15,2322720,203702.54,4514,4386,0.59,922,0,0.01
1326,台化         ,20161018,80,7.12,34636,3082.6,2342,208.44,2325304,206952.06,5428,3151,0.59,80,0,0
1326,台化         ,20161019,2525,232.3,37161,3418.81,4886,449.51,2330051,214364.69,4066,2078,0.63,2545,20,0.02
1326,台化         ,20161020,2972,276.4,40133,3732.37,3226,300.02,2333750,217038.75,3013,3210,0.68,2972,0,0.03
1326,台化         ,20161021,413,38.2,40546,3750.51,435,40.24,2334513,215942.45,7586,8587,0.69,459,46,0
1326,台化         ,20161024,329,30.43,40875,3780.94,719,66.51,2335300,216015.25,1493,1106,0.7,333,4,0
1326,台化         ,20161025,321,30.01,41196,3851.83,3567,333.51,2338930,218689.96,4171,820,0.7,321,0,0
1326,台化         ,20161026,397,37.52,41593,3930.54,1413,133.53,2341239,221247.09,3906,2888,0.71,430,33,0
1326,台化         ,20161027,367,34.2,41960,3910.67,-1828,-170.37,2339474,218038.98,1633,4141,0.72,396,29,0
1326,台化         ,20161028,292,27.56,42252,3988.59,1699,160.39,2341230,221012.11,2730,1214,0.72,320,28,0
1326,台化         ,20161031,-4,-0.38,42248,3967.09,762,71.55,2339397,219669.38,2979,2315,0.72,0,4,0
1326,台化         ,20161101,62,5.83,42310,3977.14,511,48.03,2340275,219985.85,1852,1046,0.72,114,52,0
1326,台化         ,20161102,125,11.73,42435,3971.92,-1320,-123.55,2339093,218939.1,531,1848,0.72,126,1,0
1326,台化         ,20161103,-117,-10.94,42318,3956.73,-360,-33.66,2339087,218704.63,1788,1678,0.72,76,193,0
1326,台化         ,20161104,837,78.68,43155,4056.57,1193,112.14,2340220,219980.68,1953,1657,0.74,853,16,0.01
1326,台化         ,20161107,343,32.52,43498,4123.61,697,66.08,2340451,221874.75,2050,2162,0.74,343,0,0
1326,台化         ,20161108,1007,96.77,44505,4276.93,1920,184.51,2342068,225072.73,1671,1163,0.76,1009,2,0.01
1326,台化         ,20161109,1363,127.3,45868,4284.07,-408,-38.11,2341735,218718.05,2587,4191,0.78,1425,62,0.01
1326,台化         ,20161110,1044,100.43,46912,4512.93,4849,466.47,2346509,225734.17,4386,1366,0.8,1066,22,0.01
1326,台化         ,20161111,894,85.02,47806,4546.35,-3036,-288.72,2343473,222864.28,1662,5840,0.82,953,59,0.01
1326,台化         ,20161114,109,10.36,47915,4551.93,-2416,-229.52,2341263,222419.98,2332,4633,0.82,179,70,0
1326,台化         ,20161115,707,66.74,48622,4589.92,-1950,-184.08,2339656,220863.53,1552,4408,0.83,757,50,0.01
1326,台化         ,20161116,118,11.33,48740,4679.04,1291,123.94,2340563,224694.05,3141,2176,0.83,159,41,0
1326,台化         ,20161117,537,51.61,49277,4735.52,-520,-49.97,2339483,224824.32,1334,2431,0.84,537,0,0
1326,台化         ,20161118,74,7,49351,4668.6,-1231,-116.45,2337502,221127.69,1214,3097,0.84,74,0,0
1326,台化         ,20161121,150,14.27,49501,4707.55,-288,-27.39,2337214,222269.05,1182,1508,0.84,150,0,0
1326,台化         ,20161122,123,11.92,49624,4808.57,2331,225.87,2339545,226701.91,2780,1103,0.85,165,42,0
1326,台化         ,20161123,174,17.05,49798,4880.2,2107,206.49,2341653,229481.99,1984,924,0.85,174,0,0
1326,台化         ,20161124,27,2.62,49825,4842.99,-54,-5.25,2341599,227603.42,1193,1540,0.85,27,0,0
1326,台化         ,20161125,4,0.39,49829,4863.31,577,56.32,2342176,228596.38,1079,548,0.85,4,0,0
1326,台化         ,20161128,0,0,49829,4883.24,2597,254.51,2344773,229787.75,3019,697,0.85,0,0,0
1326,台化         ,20161129,22,2.13,49851,4910.32,2912,286.83,2347685,231246.97,4612,1772,0.85,70,48,0
1326,台化         ,20161130,15,1.5,49866,4981.61,5591,558.54,2349847,234749.72,9986,4583,0.85,15,0,0
1326,台化         ,20161201,78,7.76,49944,4969.43,17,1.69,2349948,233819.83,1559,1879,0.85,78,0,0
1326,台化         ,20161202,0,0,49944,4929.47,299,29.51,2350322,231976.78,1595,1442,0.85,0,0,0
1326,台化         ,20161205,23,2.25,49967,4886.77,761,74.43,2351151,229942.57,2777,1948,0.85,23,0,0
1326,台化         ,20161206,-260,-25.74,49707,4920.99,2301,227.8,2353520,232998.48,4472,1833,0.85,0,260,0
1326,台化         ,20161207,-160,-15.78,49547,4885.33,285,28.1,2353873,232091.88,1769,1274,0.85,0,160,0
1326,台化         ,20161208,-240,-23.74,49307,4876.46,2806,277.51,2356744,233081.98,4718,1830,0.84,0,240,0
1326,台化         ,20161209,-60,-5.94,49247,4875.45,1944,192.46,2358688,233510.11,3613,1605,0.84,40,100,0
1326,台化         ,20161212,-260,-25.69,48987,4839.92,1013,100.08,2359701,233138.46,2161,846,0.84,0,260,0
1326,台化         ,20161213,-101,-9.98,48886,4829.94,260,25.69,2359961,233164.15,2900,2385,0.83,67,168,0
1326,台化         ,20161214,-384,-37.86,48502,4782.3,2495,246.01,2361815,232874.96,4331,1151,0.83,16,400,0
1326,台化         ,20161215,-602,-58.76,47900,4675.04,1404,137.03,2363527,230680.24,3490,1186,0.82,0,602,0.01
1326,台化         ,20161216,-110,-10.7,47790,4649.97,182,17.71,2363780,229995.79,4067,3694,0.82,0,110,0
1326,台化         ,20161219,-630,-60.48,47160,4527.36,-413,-39.65,2363430,226889.28,1027,747,0.8,0,630,0.01
1326,台化         ,20161220,-370,-35.82,46790,4529.27,1165,112.77,2365009,228932.87,2369,752,0.8,0,370,0
1326,台化         ,20161221,-236,-22.92,46554,4520.39,1017,98.75,2365701,229709.57,2254,1371,0.79,0,236,0
1326,台化         ,20161222,-370,-34.97,46184,4364.39,-2123,-200.62,2363807,223379.76,1251,2835,0.79,0,370,0
1326,台化         ,20161223,-888,-82.76,45296,4221.59,-1218,-113.52,2362729,220206.34,2238,2428,0.77,0,888,0.01
1326,台化         ,20161226,-765,-72.06,44531,4194.82,-446,-42.01,2362449,222542.7,987,502,0.76,0,765,0.01
1326,台化         ,20161227,0,0,44531,4163.65,-112,-10.47,2362295,220874.58,327,481,0.76,0,0,0
1326,台化         ,20161228,325,30.97,44856,4274.78,1795,171.06,2363957,225285.1,2205,928,0.77,344,19,0
1326,台化         ,20161229,42,3.98,44898,4251.84,-670,-63.45,2363041,223779.98,1803,2622,0.77,47,5,0
1326,台化         ,20161230,-763,-73.48,41526,3998.95,1813,174.59,2367394,227980.04,3179,975,0.71,22,785,0.01
1326,台化         ,20170103,800,77.84,42326,4118.32,429,41.74,2367823,230389.18,792,1463,0.72,800,0,0.01
1326,台化         ,20170104,100,9.72,42426,4123.81,96,9.33,2367919,230161.73,1305,1244,0.72,100,0,0
1326,台化         ,20170105,79,7.74,42505,4165.49,1699,166.5,2369618,232222.56,2826,1592,0.73,123,44,0
1326,台化         ,20170106,87,8.5,42592,4161.24,1934,188.95,2371562,231701.61,2436,918,0.73,131,44,0
1326,台化         ,20170109,68,6.61,42660,4146.55,2168,210.73,2373731,230726.65,2915,479,0.73,68,0,0
1326,台化         ,20170110,-304,-29.02,42356,4049.23,693,66.25,2374423,226994.84,3633,1604,0.72,124,428,0
1326,台化         ,20170111,-75,-7.18,42281,4046.29,2181,208.72,2376603,227440.91,4006,1429,0.72,89,164,0
1326,台化         ,20170112,12,1.18,42293,4144.71,4037,395.63,2380640,233302.72,5304,838,0.72,90,78,0
1326,台化         ,20170113,174,17.17,42467,4191.49,2757,272.12,2383397,235241.28,3272,470,0.72,174,0,0
1326,台化         ,20170116,580,56.55,43047,4197.08,-1005,-97.99,2382392,232283.22,258,1693,0.73,795,215,0.01
1326,台化         ,20170117,-25,-2.45,43022,4211.85,141,13.8,2382533,233249.98,1379,875,0.73,0,25,0
1326,台化         ,20170118,-297,-28.04,42725,4033.24,-3591,-338.99,2379096,224586.66,2401,5306,0.73,61,358,0
1326,台化         ,20170119,-678,-64.21,42047,3981.85,-687,-65.06,2378409,225235.33,2801,2792,0.72,150,828,0.01
1326,台化         ,20170120,-54,-5.18,41993,4031.33,-84,-8.06,2378325,228319.2,1733,1609,0.72,0,54,0
1326,台化         ,20170123,-161,-15.61,41832,4049.34,591,57.21,2378916,230279.07,3027,2362,0.71,1,162,0
1326,台化         ,20170124,-5,-0.48,41827,4048.85,-433,-41.91,2375317,229930.69,1537,1969,0.71,5,10,0
1326,台化         ,20170202,-206,-19.61,41621,3962.32,-2230,-212.3,2373698,225976.05,5560,7401,0.71,71,277,0
1326,台化         ,20170203,68,6.51,41689,3989.64,-1387,-132.74,2372604,227058.2,3654,4816,0.71,68,0,0
1326,台化         ,20170206,-263,-25.43,41426,4005.89,1574,152.21,2374245,229589.49,3517,1612,0.71,160,423,0
1326,台化         ,20170207,4,0.39,41430,4060.14,4542,445.12,2379160,233157.68,5884,1149,0.71,120,116,0
1326,台化         ,20170208,0,0,41430,4035.28,-952,-92.72,2378524,231668.24,1912,2555,0.71,0,0,0
1326,台化         ,20170209,56,5.43,41486,4024.14,-499,-48.4,2378096,230675.31,2387,2881,0.71,106,50,0
1326,台化         ,20170210,-338,-33.43,41148,4073.65,1640,162.36,2379083,235529.22,4675,3394,0.7,0,338,0
1326,台化         ,20170213,766,76.37,41914,4178.83,1632,162.71,2380731,237358.88,1813,941,0.72,773,7,0.01
1326,台化         ,20170214,-61,-6.04,41853,4143.45,56,5.54,2380782,235697.42,2257,2155,0.71,260,321,0
1326,台化         ,20170215,0,0,41853,4164.37,3872,385.26,2384253,237233.17,5372,2283,0.71,0,0,0
1326,台化         ,20170216,59,5.81,41912,4128.33,2692,265.16,2386945,235114.08,4134,1562,0.72,59,0,0
1326,台化         ,20170217,-162,-15.97,41750,4116.55,976,96.23,2387921,235449.01,2223,1008,0.71,1,163,0
1326,台化         ,20170218,0,0,41750,4091.5,-11,-1.08,2387910,234015.18,1,0,0.71,0,0,0
1326,台化         ,20170220,-629,-61.52,41121,4021.63,254,24.84,2388164,233562.44,2021,889,0.7,0,629,0.01
1326,台化         ,20170221,900,88.83,42021,4147.47,2705,266.98,2391366,236027.82,3181,779,0.72,900,0,0.01
1326,台化         ,20170222,0,0,42021,4139.07,1603,157.9,2392799,235690.7,3999,2321,0.72,0,0,0
1326,台化         ,20170223,-106,-10.34,41915,4086.71,-149,-14.53,2392822,233300.14,1750,1631,0.72,36,142,0
1326,台化         ,20170224,-23,-2.24,41892,4071.9,291,28.29,2393233,232622.25,1897,1462,0.71,0,23,0
1326,台化         ,20170301,-135,-12.83,41757,3966.92,-2458,-233.51,2391006,227145.57,1404,3497,0.71,0,135,0
1326,台化         ,20170302,-70,-6.63,41687,3947.76,849,80.4,2392062,226528.27,4338,3212,0.71,0,70,0
1326,台化         ,20170303,-1400,-131.74,40287,3791.01,189,17.78,2392265,225112.14,3249,1646,0.69,3,1403,0.01
1326,台化         ,20170306,-224,-21.26,40063,3801.98,1061,100.69,2393385,227132.24,3564,2221,0.68,0,224,0
1326,台化         ,20170307,261,25.19,40324,3891.27,583,56.26,2393902,231011.54,2731,2468,0.69,261,0,0
1326,台化         ,20170308,78,7.43,40402,3846.27,-1161,-110.53,2392919,227805.89,1785,2846,0.69,300,222,0
1326,台化         ,20170309,-762,-70.64,39640,3674.63,-3930,-364.31,2389206,221479.4,1974,4925,0.68,45,807,0.01
1326,台化         ,20170310,-1746,-160.63,37894,3486.25,-1944,-178.85,2387313,219632.8,1642,1789,0.65,21,1767,0.02
1326,台化         ,20170313,-204,-18.77,37690,3467.48,39,3.59,2387197,219622.12,806,718,0.64,50,254,0
1326,台化         ,20170314,-61,-5.63,37629,3473.16,780,71.99,2387906,220403.72,2221,1452,0.64,27,88,0
1326,台化         ,20170315,-383,-35.35,37246,3437.81,-645,-59.53,2387034,220323.24,1485,1974,0.64,77,460,0
1326,台化         ,20170316,50,4.72,37296,3520.74,1876,177.09,2388754,225498.38,4196,2526,0.64,50,0,0
1326,台化         ,20170317,-301,-28.35,36995,3484.93,-872,-82.14,2387866,224936.98,5772,6359,0.63,7,308,0
1326,台化         ,20170320,-205,-19.29,36790,3461.94,-303,-28.51,2387634,224676.36,903,930,0.63,0,205,0
1326,台化         ,20170321,-97,-9.26,36693,3504.18,3962,378.37,2391512,228389.4,4443,468,0.63,3,100,0
1326,台化         ,20170322,43,4.11,36736,3508.29,2333,222.8,2394000,228627,4797,2393,0.63,150,107,0
1326,台化         ,20170323,-366,-34.62,36370,3440.6,-693,-65.56,2393252,226401.64,2104,2486,0.62,0,366,0
1326,台化         ,20170324,-376,-35.34,35994,3383.44,-18,-1.69,2393427,224982.14,2385,1834,0.61,51,427,0
1326,台化         ,20170327,-692,-65.67,35302,3350.16,1541,146.24,2396021,227382.39,3178,1004,0.6,100,792,0.01
1326,台化         ,20170328,-409,-38.65,34893,3297.39,1339,126.54,2397476,226561.48,4265,2401,0.6,85,494,0
1326,台化         ,20170329,80,7.52,34973,3287.46,29,2.73,2397270,225343.38,1657,1943,0.6,80,0,0
1326,台化         ,20170330,70,6.52,35043,3262.5,-902,-83.98,2396483,223112.57,2379,3236,0.6,70,0,0
1326,台化         ,20170331,-630,-59.47,34379,3245.38,2074,195.79,2397767,226349.2,7380,4320,0.59,100,730,0.01
1326,台化         ,20170405,80,7.6,34459,3273.61,-325,-30.88,2397442,227756.99,4088,4533,0.59,80,0,0
1326,台化         ,20170406,-255,-23.92,34204,3208.34,-1772,-166.21,2395670,224713.85,2534,4105,0.58,57,312,0
1326,台化         ,20170407,-158,-14.79,34046,3186.71,-2020,-189.07,2393650,224045.64,4149,6020,0.58,3,161,0
1326,台化         ,20170410,-69,-6.54,33977,3221.02,-1075,-101.91,2392575,226816.11,1603,2645,0.58,2,71,0
1326,台化         ,20170411,185,17.48,34162,3228.31,2107,199.11,2394683,226297.54,7037,5154,0.58,185,0,0
1326,台化         ,20170412,108,10.25,34270,3252.22,1967,186.67,2396650,227442.09,4122,2194,0.58,127,19,0
1326,台化         ,20170413,127,12.05,34397,3264.28,950,90.16,2397750,227546.48,1444,1083,0.59,127,0,0
1326,台化         ,20170414,33,3.1,34430,3236.42,-236,-22.18,2397514,225366.32,612,904,0.59,50,17,0
1326,台化         ,20170417,58,5.45,34488,3241.87,361,33.93,2397875,225400.25,946,632,0.59,58,0,0
1326,台化         ,20170418,416,39.15,34904,3284.47,-376,-35.38,2397499,225604.66,1148,1933,0.6,416,0,0
1326,台化         ,20170419,0,0,34904,3249.56,-2253,-209.75,2395246,222997.4,1874,3871,0.6,0,0,0
1326,台化         ,20170420,-1038,-95.5,33866,3115.67,-2536,-233.31,2392657,220124.44,1010,2543,0.58,2,1040,0.01
1326,台化         ,20170421,-10,-0.93,33856,3145.22,106,9.85,2392764,222287.78,730,582,0.58,40,50,0
1326,台化         ,20170424,0,0,33856,3148.61,1149,106.86,2393913,222633.91,1632,493,0.58,0,0,0
1326,台化         ,20170425,-508,-47.75,33348,3134.71,708,66.55,2394566,225089.2,5439,4268,0.57,0,508,0
1326,台化         ,20170426,-432,-39.74,32916,3028.27,-6499,-597.91,2388067,219702.16,3587,9784,0.56,1,433,0
1326,台化         ,20170427,-458,-42.14,32458,2986.14,-1811,-166.61,2386256,219535.55,1800,2997,0.55,1,459,0
1326,台化         ,20170428,-41,-3.8,32417,3008.3,-341,-31.64,2385662,221389.43,3101,3301,0.55,0,41,0
1326,台化         ,20170502,-120,-11.2,32297,3013.31,-302,-28.18,2385843,222599.15,2994,3176,0.55,0,120,0
1326,台化         ,20170503,-111,-10.32,32186,2993.3,-1107,-102.95,2384736,221780.45,1171,2194,0.55,0,111,0
1326,台化         ,20170504,-249,-23.21,31937,2976.53,-377,-35.14,2384359,222222.26,1434,1562,0.54,0,249,0
1326,台化         ,20170505,-348,-31.84,31589,2890.39,-3593,-328.76,2380766,217840.09,1257,4559,0.54,0,348,0
1326,台化         ,20170508,-234,-21.55,31355,2887.8,259,23.85,2381025,219292.4,2025,1478,0.53,32,266,0
1326,台化         ,20170509,-871,-77.69,30484,2719.17,-6941,-619.14,2374454,211801.3,1437,7107,0.52,0,871,0.01
1326,台化         ,20170510,-821,-72.74,29663,2628.14,-5537,-490.58,2368980,209891.63,2993,7646,0.51,0,821,0.01
1326,台化         ,20170511,206,18.75,29869,2718.08,1965,178.82,2371106,215770.65,5395,3475,0.51,256,50,0
1326,台化         ,20170512,-63,-5.76,29806,2724.27,2230,203.82,2373095,216900.88,4216,1895,0.51,0,63,0
1326,台化         ,20170515,160,14.59,29966,2732.9,-737,-67.21,2372380,216361.06,1847,2722,0.51,230,70,0
1326,台化         ,20170516,469,42.12,30435,2733.06,-9056,-813.23,2363292,212223.62,2942,12798,0.52,676,207,0.01
1326,台化         ,20170517,257,23.16,30692,2765.35,484,43.61,2363922,212989.37,3188,2837,0.52,261,4,0
1326,台化         ,20170518,52,4.68,30744,2766.96,-907,-81.63,2363009,212670.81,2230,3194,0.52,70,18,0
1326,台化         ,20170519,-172,-15.39,30572,2736.19,-90,-8.06,2362676,211459.5,2656,2817,0.52,0,172,0
1326,台化         ,20170522,-341,-31.1,30231,2757.07,2111,192.52,2364945,215682.98,4867,2257,0.52,0,341,0
1326,台化         ,20170523,-227,-20.68,30004,2733.36,1068,97.29,2365913,215534.67,4127,2932,0.51,0,227,0
1326,台化         ,20170524,0,0,30004,2700.36,-2087,-187.83,2363580,212722.2,920,3302,0.51,0,0,0
1326,台化         ,20170525,-306,-27.85,29698,2702.52,484,44.04,2364079,215131.19,2292,2458,0.51,0,306,0
1326,台化         ,20170526,-234,-21.34,29464,2687.12,-1155,-105.34,2363084,215513.26,4567,5540,0.5,0,234,0
1326,台化         ,20170531,-109,-9.95,29355,2680.11,-2479,-226.33,2359355,215409.11,25282,27844,0.5,0,109,0
1326,台化         ,20170601,-170,-15.4,29185,2644.16,-2899,-262.65,2356588,213506.87,1945,4542,0.5,0,170,0
1326,台化         ,20170602,-322,-28.82,28863,2583.24,-6505,-582.2,2350065,210330.82,2671,8872,0.49,0,322,0
1326,台化         ,20170603,-247,-22.4,28616,2595.47,-271,-24.58,2349818,213128.49,0,0,0.49,0,247,0
1326,台化         ,20170605,-30,-2.77,28586,2638.49,777,71.72,2350684,216968.13,4593,3697,0.49,0,30,0
1326,台化         ,20170606,-38,-3.51,28548,2634.98,-1439,-132.82,2348916,216804.95,1573,3415,0.49,0,38,0
1326,台化         ,20170607,-18,-1.64,28530,2604.79,-4029,-367.85,2344887,214088.18,1912,6542,0.49,0,18,0
1326,台化         ,20170608,-64,-5.77,28466,2564.79,-3919,-353.1,2340968,210921.22,1001,5756,0.49,0,64,0
1326,台化         ,20170609,-698,-62.89,27768,2501.9,-2463,-221.92,2338505,210699.3,3706,5765,0.47,0,698,0.01
1326,台化         ,20170612,0,0,27768,2499.12,-2212,-199.08,2336059,210245.31,1776,4249,0.47,0,0,0
1326,台化         ,20170613,-154,-13.94,27614,2499.07,-874,-79.1,2333923,211220.03,1477,3098,0.47,0,154,0
1326,台化         ,20170614,-7,-0.63,27607,2501.19,-494,-44.76,2332117,211289.8,1996,3039,0.47,0,7,0
1326,台化         ,20170615,-11,-0.99,27596,2486.4,-3957,-356.53,2326724,209637.83,1152,4921,0.47,0,11,0
1326,台化         ,20170616,-4220,-379.38,23376,2101.5,-1963,-176.47,2323686,208899.37,39722,40417,0.4,0,4220,0.04
1326,台化         ,20170619,-309,-28.3,23067,2112.94,597,54.69,2324283,212904.32,3030,2237,0.39,5,314,0
1326,台化         ,20170620,3,0.28,23070,2115.52,-998,-91.52,2323135,213031.48,1477,2738,0.39,20,17,0
1326,台化         ,20170621,85,7.82,23155,2130.26,-1842,-169.46,2321083,213539.64,4419,6412,0.4,160,75,0
1326,台化         ,20170622,-96,-8.84,23059,2123.73,-2116,-194.88,2321900,213846.99,1728,3751,0.39,0,96,0
1326,台化         ,20170623,-556,-51.21,22503,2072.53,-2079,-191.48,2319236,213601.64,3087,4585,0.38,0,556,0
1326,台化         ,20170626,52,4.89,22555,2120.17,2413,226.82,2320795,218154.73,31536,29750,0.38,60,8,0
1326,台化         ,20170627,-34,-3.24,22521,2146.25,332,31.64,2321127,221203.4,4271,4087,0.38,0,34,0
1326,台化         ,20170628,318,30.15,22839,2165.14,-263,-24.93,2320864,220017.91,3269,4019,0.39,388,70,0
1326,台化         ,20170629,253,24.06,23092,2196.05,-2659,-252.87,2320211,220652.07,1678,4537,0.39,276,23,0
1326,台化         ,20170630,73,6.97,26560,2536.48,731,69.81,2316452,221221.17,3992,3521,0.45,73,0,0
1326,台化         ,20170703,-77,-7.41,26483,2547.66,33,3.17,2316484,222845.76,2403,2494,0.45,0,77,0
1326,台化         ,20170704,2,0.19,26485,2547.86,-1176,-113.13,2313220,222531.76,3739,5331,0.45,81,79,0
1326,台化         ,20170705,0,0,26485,2545.21,976,93.79,2314196,222394.24,2229,3135,0.45,0,0,0
1326,台化         ,20170706,-498,-45.22,25987,2359.62,-1028,-93.34,2313026,210022.76,3911,2512,0.44,112,610,0.01
1326,台化         ,20170707,-90,-8.1,25897,2330.73,-1506,-135.54,2311520,208036.8,1296,2547,0.44,0,90,0
1326,台化         ,20170710,-66,-5.93,25831,2322.21,1017,91.43,2312543,207897.62,2980,1767,0.44,0,66,0
1326,台化         ,20170711,-158,-14.27,25673,2318.27,324,29.26,2312867,208851.89,1487,1118,0.44,0,158,0
1326,台化         ,20170712,19,1.74,25692,2353.39,1061,97.19,2313927,211955.71,3130,1892,0.44,50,31,0
1326,台化         ,20170713,-55,-5.09,25637,2371.42,256,23.68,2314183,214061.93,2453,2050,0.44,1,56,0
1326,台化         ,20170714,-116,-10.6,25521,2332.62,-1779,-162.6,2312404,211353.73,821,2460,0.44,0,116,0
1326,台化         ,20170717,-92,-8.45,25429,2342.01,20,1.84,2312424,212974.25,1124,983,0.43,0,92,0
1326,台化         ,20170718,-94,-8.62,25335,2323.22,-622,-57.04,2311803,211992.34,1074,1568,0.43,19,113,0
1326,台化         ,20170719,0,0,25335,2335.89,-1512,-139.41,2311490,213119.38,1224,1417,0.43,0,0,0
1326,台化         ,20170720,2,0.18,25337,2325.94,-1498,-137.52,2310009,212058.83,652,2134,0.43,2,0,0
1326,台化         ,20170721,-68,-6.17,25269,2294.43,-1765,-160.26,2308207,209585.2,1034,2768,0.43,0,68,0
1326,台化         ,20170724,-365,-33.43,24904,2281.21,410,37.56,2308851,211490.75,1771,1003,0.42,0,365,0
1326,台化         ,20170725,2,0.18,24906,2256.48,-938,-84.98,2308431,209143.85,779,1743,0.42,2,0,0
1326,台化         ,20170726,-417,-37.53,24489,2204.01,-352,-31.68,2309845,207886.05,1488,1164,0.42,0,417,0
1326,台化         ,20170727,-64,-5.88,24425,2242.22,1924,176.62,2312289,212268.13,2855,872,0.42,0,64,0
1326,台化         ,20170728,1,0.09,24426,2222.77,112,10.19,2312570,210443.87,1217,1135,0.42,1,0,0
1326,台化         ,20170731,7,0.64,24433,2223.4,627,57.06,2313266,210507.21,3999,3310,0.42,7,0,0
1326,台化         ,20170801,-15,-1.38,24418,2239.13,227,20.82,2313492,212147.22,1619,1383,0.42,3,18,0
1326,台化         ,20170802,-4,-0.37,24414,2233.88,372,34.04,2313865,211718.65,976,616,0.42,6,10,0
1326,台化         ,20170803,-314,-28.79,24100,2209.97,-998,-91.52,2313036,212105.4,954,1447,0.41,6,320,0
1326,台化         ,20170804,-12,-1.11,24088,2220.91,-523,-48.22,2312657,213226.98,698,1064,0.41,15,27,0
1326,台化         ,20170807,7,0.65,24095,2233.61,-619,-57.38,2311820,214305.71,755,1599,0.41,7,0,0
1326,台化         ,20170808,3,0.28,24098,2238.7,11,1.02,2311781,214764.45,2958,3000,0.41,9,6,0
1326,台化         ,20170809,13,1.21,24111,2235.09,-1207,-111.89,2310822,214213.2,2345,3317,0.41,13,0,0
1326,台化         ,20170810,1,0.09,24112,2206.25,-727,-66.52,2310042,211368.84,2027,2808,0.41,1,0,0
1326,台化         ,20170811,-23,-2.1,24089,2204.14,-1428,-130.66,2308875,211262.06,805,2222,0.41,0,23,0
1326,台化         ,20170814,-2,-0.18,24087,2206.37,-733,-67.14,2308203,211431.39,444,1115,0.41,0,2,0
1326,台化         ,20170815,125,11.45,24212,2217.82,-631,-57.8,2307773,211392.01,883,1563,0.41,127,2,0
1326,台化         ,20170816,277,25.35,24489,2240.74,-931,-85.19,2306959,211086.75,1668,2759,0.42,458,181,0.01
1326,台化         ,20170817,0,0,24489,2257.89,273,25.17,2307566,212757.59,1939,1591,0.42,0,0,0
1326,台化         ,20170818,0,0,24489,2248.09,-1307,-119.98,2306827,211766.72,813,2074,0.42,0,0,0
1326,台化         ,20170821,40,3.68,24529,2256.67,-279,-25.67,2306576,212204.99,674,965,0.42,40,0,0
1326,台化         ,20170822,0,0,24529,2276.29,410,38.05,2306977,214087.47,1862,1461,0.42,0,0,0
1326,台化         ,20170823,64,5.98,24593,2299.45,-751,-70.22,2306608,215667.85,771,1203,0.42,67,3,0
1326,台化         ,20170824,98,9.19,24691,2316.02,367,34.42,2306929,216389.94,2443,2221,0.42,98,0,0
1326,台化         ,20170825,-48,-4.5,24643,2311.51,-929,-87.14,2306057,216308.15,1201,2065,0.42,0,48,0
1326,台化         ,20170828,77,7.25,24720,2328.62,-1387,-130.66,2304530,217086.73,1425,3028,0.42,82,5,0
1326,台化         ,20170829,-5,-0.47,24715,2333.1,-368,-34.74,2304346,217530.26,965,1144,0.42,0,5,0
1326,台化         ,20170830,0,0,24715,2345.45,61,5.79,2304492,218696.29,2294,2148,0.42,0,0,0
1326,台化         ,20170831,0,0,24715,2345.45,-1090,-103.44,2305368,218779.42,1941,3005,0.42,0,0,0
1326,台化         ,20170901,-40,-3.8,24675,2344.13,-1115,-105.93,2304253,218904.04,887,1984,0.42,23,63,0
1326,台化         ,20170904,0,0,24675,2336.72,-364,-34.47,2303889,218178.29,575,924,0.42,0,0,0
1326,台化         ,20170905,563,53.77,25238,2410.23,382,36.48,2301893,219830.78,3086,2974,0.43,563,0,0
1326,台化         ,20170906,-3,-0.29,25235,2399.85,-796,-75.7,2301595,218881.68,3207,3932,0.43,0,3,0
1326,台化         ,20170907,60,5.74,25295,2418.2,-545,-52.1,2301094,219984.59,1551,2113,0.43,60,0,0
1326,台化         ,20170908,-10,-0.96,25285,2424.83,-589,-56.49,2306743,221216.65,2424,2890,0.43,18,28,0
1326,台化         ,20170911,0,0,25285,2417.25,-2,-0.19,2306950,220544.42,1443,1447,0.43,0,0,0
1326,台化         ,20170912,66,6.34,25351,2433.7,429,41.18,2307358,221506.37,1641,1298,0.43,66,0,0
1326,台化         ,20170913,5,0.47,25356,2403.75,117,11.09,2307642,218764.46,1231,952,0.43,5,0,0
1326,台化         ,20170914,119,11.2,25475,2397.2,438,41.22,2308004,217183.18,1374,1131,0.43,122,3,0
1326,台化         ,20170915,231,21.64,25706,2408.65,-143,-13.4,2307844,216244.98,6113,6504,0.44,233,2,0
1326,台化         ,20170918,141,13.42,25847,2460.63,823,78.35,2308769,219794.81,1944,1226,0.44,144,3,0
1326,台化         ,20170919,39,3.67,25886,2435.87,-1342,-126.28,2307453,217131.33,1023,2377,0.44,46,7,0
1326,台化         ,20170920,0,0,25886,2433.28,-883,-83,2306698,216829.61,1066,1831,0.44,0,0,0
1326,台化         ,20170921,0,0,25886,2420.34,-1003,-93.78,2305582,215571.92,730,1846,0.44,0,0,0
1326,台化         ,20170922,60,5.59,25946,2418.17,-129,-12.02,2303915,214724.88,817,1045,0.44,70,10,0
1326,台化         ,20170925,4,0.37,25950,2405.57,-71,-6.58,2303825,213564.58,1337,1431,0.44,41,37,0
1326,台化         ,20170926,229,21.21,26179,2424.18,360,33.34,2304242,213372.81,939,719,0.45,234,5,0
1326,台化         ,20170927,3,0.28,26182,2408.74,-869,-79.95,2303250,211899,923,1884,0.45,8,5,0
1326,台化         ,20170928,17,1.54,26199,2378.87,-574,-52.12,2302463,209063.64,1601,2336,0.45,17,0,0
1326,台化         ,20170929,-1,-0.09,26198,2415.46,718,66.2,2303249,212359.56,2490,1634,0.45,0,1,0
1326,台化         ,20170930,50,4.61,23297,2145.65,78,7.18,2300348,211862.05,0,0,0.4,50,0,0
1326,台化         ,20171002,58,5.33,23355,2146.32,-124,-11.4,2297946,211181.24,965,1254,0.4,58,0,0
1326,台化         ,20171003,-30,-2.71,23325,2136.57,-965,-88.39,2299567,210640.34,707,1711,0.4,6,36,0
1326,台化         ,20171005,-17,-1.55,23308,2130.35,-39,-3.56,2299538,210177.77,906,957,0.4,69,86,0
1326,台化         ,20171006,-6,-0.55,23302,2141.45,329,30.24,2299867,211357.78,1984,1659,0.4,9,15,0
1326,台化         ,20171011,61,5.76,23363,2205.47,1636,154.44,2301502,217261.79,4188,2475,0.4,65,4,0
1326,台化         ,20171012,-91,-8.58,23272,2194.55,105,9.9,2301607,217041.54,2187,1944,0.4,37,128,0
1326,台化         ,20171013,48,4.51,23320,2189.75,381,35.78,2302009,216158.65,1967,1583,0.4,48,0,0
1326,台化         ,20171016,8,0.76,23328,2211.49,1557,147.6,2303550,218376.54,2614,1103,0.4,79,71,0
1326,台化         ,20171017,-29,-2.74,23299,2199.43,1632,154.06,2305182,217609.18,3009,1414,0.4,0,29,0
1326,台化         ,20171018,291,27.35,23590,2217.46,13,1.22,2305195,216688.33,1849,2193,0.4,294,3,0
1326,台化         ,20171019,-28,-2.62,23562,2205.4,-250,-23.4,2304945,215742.85,1408,1850,0.4,0,28,0
1326,台化         ,20171020,63,5.92,23625,2220.75,169,15.89,2305138,216682.97,3659,3498,0.4,63,0,0
1326,台化         ,20171023,-1396,-128.57,22229,2047.29,-2688,-247.56,2302440,212054.72,1050,2482,0.38,0,1396,0.01
1326,台化         ,20171024,-53,-4.9,22176,2051.28,302,27.93,2302742,213003.64,1944,1626,0.38,0,53,0
1326,台化         ,20171025,-109,-10.07,22067,2038.99,-362,-33.45,2302871,212785.28,4206,4477,0.38,66,175,0
1326,台化         ,20171026,-3,-0.28,22064,2034.3,-361,-33.28,2302510,212291.42,1578,1849,0.38,0,3,0
1326,台化         ,20171027,0,0,22064,2029.89,-300,-27.6,2302210,211803.32,752,901,0.38,0,0,0
1326,台化         ,20171030,0,0,22064,2023.27,-483,-44.29,2301727,211068.37,1506,2042,0.38,0,0,0
1326,台化         ,20171031,1,0.09,22065,2021.15,-979,-89.68,2300690,210743.2,1418,2433,0.38,1,0,0
1326,台化         ,20171101,-3,-0.28,22062,2027.5,-538,-49.44,2300172,211385.81,508,1018,0.38,7,10,0
1326,台化         ,20171102,-79,-7.24,21983,2015.84,-535,-49.06,2299612,210874.42,428,943,0.38,0,79,0
1326,台化         ,20171103,-31,-2.87,21952,2030.56,-143,-13.23,2299469,212700.88,992,1150,0.37,1,32,0
1326,台化         ,20171106,-35,-3.21,21917,2011.98,-2281,-209.4,2297188,210881.86,610,2798,0.37,0,35,0
1326,台化         ,20171107,0,0,21917,2027.32,-1265,-117.01,2296121,212391.19,1567,3400,0.37,0,0,0
1326,台化         ,20171108,-188,-17.48,21729,2020.8,146,13.58,2296267,213552.83,1695,1274,0.37,0,188,0
1326,台化         ,20171109,-6,-0.56,21723,2024.58,229,21.34,2296496,214033.43,2116,1747,0.37,4,10,0
1326,台化         ,20171110,5,0.47,21728,2029.4,87,8.13,2296582,214500.76,1209,1123,0.37,5,0,0
1326,台化         ,20171113,12,1.13,21740,2047.91,783,73.76,2297365,216411.78,1830,1181,0.37,13,1,0
1326,台化         ,20171114,21,1.99,21761,2062.94,402,38.11,2297767,217828.31,1742,1329,0.37,29,8,0
1326,台化         ,20171115,52,4.87,21813,2043.88,-1511,-141.58,2296266,215160.12,1442,3073,0.37,52,0,0
1326,台化         ,20171116,42,3.94,21855,2047.81,-166,-15.55,2296100,215144.57,1168,1323,0.37,42,0,0
1326,台化         ,20171117,-1,-0.09,21854,2030.24,-1607,-149.29,2294498,213158.86,1967,3658,0.37,0,1,0
1326,台化         ,20171120,0,0,21854,2049.91,-310,-29.08,2294188,215194.83,1511,1726,0.37,0,0,0
1326,台化         ,20171121,-300,-28.05,21554,2015.3,275,25.71,2294470,214532.95,2333,1772,0.37,0,300,0
1326,台化         ,20171122,47,4.44,21601,2041.29,1644,155.36,2296114,216982.77,3456,2234,0.37,47,0,0
1326,台化         ,20171123,139,13.14,21740,2054.43,239,22.59,2296352,217005.26,640,649,0.37,144,5,0
1326,台化         ,20171124,-29,-2.72,21711,2036.49,-147,-13.79,2296205,215384.03,1050,1206,0.37,30,59,0
1326,台化         ,20171127,0,0,21711,2060.37,837,79.43,2297043,217989.38,1930,1248,0.37,0,0,0
1326,台化         ,20171128,-195,-18.25,21516,2013.9,-892,-83.49,2296271,214930.97,1182,1996,0.37,0,195,0
1326,台化         ,20171129,-38,-3.57,21478,2016.78,-242,-22.72,2296029,215597.12,1896,2127,0.37,0,38,0
1326,台化         ,20171130,-77,-7.01,21401,1947.49,-5458,-496.68,2289421,208337.31,8483,13720,0.37,2,79,0
1326,台化         ,20171201,258,24.33,21659,2042.44,-57,-5.38,2289400,215890.42,1812,2092,0.37,258,0,0
1326,台化         ,20171204,238,22.61,21897,2080.22,715,67.93,2290079,217557.51,1570,1164,0.37,238,0,0
1326,台化         ,20171205,1130,108.25,23027,2205.99,1567,150.12,2291647,219539.78,2533,2506,0.39,1146,16,0.01
1326,台化         ,20171206,707,67.52,23734,2266.6,-59,-5.63,2290580,218750.39,2153,2917,0.4,707,0,0.01
1326,台化         ,20171207,673,63.33,24407,2296.7,-822,-77.35,2288868,215382.48,1609,3206,0.42,674,1,0.01
1326,台化         ,20171208,0,0,24407,2304.02,-125,-11.8,2288700,216053.28,1540,1653,0.42,0,0,0
1326,台化         ,20171211,103,9.66,24510,2299.04,-828,-77.67,2287829,214598.36,957,1959,0.42,103,0,0
1326,台化         ,20171212,17,1.6,24527,2312.9,-1118,-105.43,2286609,215627.23,1737,2845,0.42,17,0,0
1326,台化         ,20171213,24,2.26,24551,2315.16,-77,-7.26,2286497,215616.67,1436,1617,0.42,24,0,0
1326,台化         ,20171214,100,9.51,24651,2344.31,-362,-34.43,2286135,217411.44,2155,2575,0.42,100,0,0
1326,台化         ,20171215,3550,338.67,28201,2690.38,3093,295.07,2289238,218393.31,5069,5684,0.48,3570,20,0.03
1326,台化         ,20171218,875,86.01,29076,2858.17,2483,244.08,2291652,225269.39,3289,2478,0.5,875,0,0.01
1326,台化         ,20171219,1165,114.75,30241,2978.74,838,82.54,2292490,225810.27,4074,6120,0.52,1165,0,0.01
1326,台化         ,20171220,463,45.51,30704,3018.2,512,50.33,2292933,225395.31,1543,1524,0.52,463,0,0
1326,台化         ,20171221,20,1.95,30724,3001.73,471,46.02,2293369,224062.15,1400,1177,0.52,20,0,0
1326,台化         ,20171222,326,31.79,31050,3027.38,1342,130.85,2294683,223731.59,2841,1864,0.53,326,0,0
1326,台化         ,20171225,51,4.99,31101,3044.79,431,42.19,2295114,224691.66,689,316,0.53,51,0,0
1326,台化         ,20171226,257,25.2,31358,3073.08,121,11.86,2295512,224960.18,587,526,0.54,258,1,0
1326,台化         ,20171227,2538,256.34,33896,3423.5,4378,442.18,2299890,232288.89,2545,1419,0.58,2543,5,0.02
1326,台化         ,20171228,982,98.69,34878,3505.24,3643,366.12,2303533,231505.07,4677,1193,0.6,982,0,0.01
1326,台化         ,20171229,1368,140.9,35059,3611.08,6927,713.48,2309547,237883.34,6434,1177,0.6,1414,46,0.01
1326,台化         ,20180102,1434,148.42,36493,3777.03,5056,523.3,2314603,239561.41,3897,876,0.62,1434,0,0.01
1326,台化         ,20180103,373,38.61,36866,3815.63,2447,253.26,2317050,239814.68,1247,1142,0.63,373,0,0
1326,台化         ,20180104,-488,-51,36378,3801.5,2422,253.1,2319472,242384.82,3446,1309,0.62,121,609,0.01
1326,台化         ,20180105,159,16.54,36537,3799.85,1981,206.02,2321767,241463.77,2849,1476,0.62,247,88,0
1326,台化         ,20180108,57,6.01,36594,3860.67,1230,129.76,2322997,245076.18,3392,2286,0.62,57,0,0
1326,台化         ,20180109,1698,186.78,38292,4212.12,6175,679.25,2329172,256208.92,10607,6282,0.65,1698,0,0.01
1326,台化         ,20180110,1132,122.26,39424,4257.79,1533,165.56,2330705,251716.14,2389,3034,0.67,1240,108,0.01
1326,台化         ,20180111,1561,170.15,40985,4467.36,4611,502.6,2335316,254549.44,4075,1104,0.7,1561,0,0.01
1326,台化         ,20180112,326,35.37,41311,4482.24,2618,284.05,2337934,253665.84,4339,2069,0.7,476,150,0.01
1326,台化         ,20180115,915,99.74,42226,4602.63,1455,158.6,2339389,254993.4,1682,726,0.72,916,1,0.01
1326,台化         ,20180116,244,26.47,42470,4608,1787,193.89,2341146,254014.34,3545,1618,0.72,400,156,0
1326,台化         ,20180117,0,0,42470,4586.76,2713,293,2343858,253136.66,5142,1791,0.72,0,0,0
1326,台化         ,20180118,200,21.8,42670,4651.03,3584,390.66,2342001,255278.11,4511,928,0.73,200,0,0
1326,台化         ,20180119,72,7.74,42742,4594.77,59,6.34,2342352,251802.84,1966,1866,0.73,164,92,0
1326,台化         ,20180122,10,1.09,42752,4659.97,1103,120.23,2343455,255436.6,2588,943,0.73,63,53,0
1326,台化         ,20180123,-73,-7.96,42679,4652.01,1372,149.55,2344828,255586.25,3002,1566,0.73,0,73,0
1326,台化         ,20180124,52,5.59,42731,4593.58,498,53.53,2345353,252125.45,2333,1999,0.73,60,8,0
1326,台化         ,20180125,0,0,42731,4657.68,5051,550.56,2350473,256201.56,6041,1068,0.73,0,0,0
1326,台化         ,20180126,34,3.77,42765,4746.92,2862,317.68,2353335,261220.19,3953,1320,0.73,250,216,0
1326,台化         ,20180129,70,8.02,42835,4904.61,1232,141.06,2354580,269599.41,4867,3678,0.73,70,0,0
1326,台化         ,20180130,96,10.51,42931,4700.94,-2009,-219.99,2352381,257585.72,2764,4770,0.73,166,70,0
1326,台化         ,20180131,-40,-4.36,42891,4675.12,2117,230.75,2347070,255830.63,3845,2073,0.73,36,76,0
1326,台化         ,20180201,-335,-37.02,42556,4702.44,3470,383.44,2350681,259750.25,4889,943,0.73,120,455,0
1326,台化         ,20180202,130,13.91,42686,4567.4,92,9.84,2350636,251518.05,2260,2475,0.73,209,79,0
1326,台化         ,20180205,-110,-11.83,42576,4576.92,1675,180.06,2352691,252914.28,6449,4242,0.73,120,230,0
1326,台化         ,20180206,61,6.28,42637,4391.61,-2653,-273.26,2350747,242126.94,5394,7409,0.73,296,235,0
1326,台化         ,20180207,45,4.84,42682,4588.31,-3054,-328.31,2348084,252419.03,7050,9611,0.73,65,20,0
1326,台化         ,20180208,53,5.75,42735,4636.75,1523,165.25,2349593,254930.84,4981,3441,0.73,122,69,0
1326,台化         ,20180209,-186,-19.62,42549,4488.92,-4508,-475.59,2344578,247352.98,2012,6840,0.73,11,197,0
1326,台化         ,20180212,-140,-14.77,42409,4474.15,-5484,-578.56,2339024,246767.03,2762,8163,0.72,0,140,0
1326,台化         ,20180221,-54,-5.91,42355,4637.87,872,95.48,2340517,256286.61,5510,3829,0.72,15,69,0
1326,台化         ,20180222,-513,-54.63,41842,4456.17,-1580,-168.27,2338019,248999.02,2214,4141,0.71,22,535,0
1326,台化         ,20180223,-54,-5.89,41788,4554.89,750,81.75,2338943,254944.79,2473,1495,0.71,4,58,0
1326,台化         ,20180226,-134,-14.61,41654,4540.29,411,44.8,2339362,254990.46,2096,1477,0.71,23,157,0
1326,台化         ,20180227,0,0,41654,4519.46,-143,-15.52,2339217,253805.04,4132,4278,0.71,10,10,0
1326,台化         ,20180301,-28,-2.97,41626,4412.36,-167,-17.7,2339050,247939.3,3499,4191,0.71,10,38,0
1326,台化         ,20180302,-230,-24.15,41396,4346.58,-989,-103.85,2338061,245496.41,2202,2938,0.71,3,233,0
1326,台化         ,20180305,29,3.05,41425,4349.63,-2309,-242.45,2335752,245253.96,3199,5450,0.71,35,6,0
1326,台化         ,20180306,-154,-16.32,41271,4374.73,668,70.81,2336420,247660.52,1643,837,0.7,0,154,0
1326,台化         ,20180307,-1802,-190.11,39469,4163.98,-2553,-269.34,2333867,246222.97,3835,4540,0.67,0,1802,0.02
1326,台化         ,20180308,-919,-96.95,38550,4067.03,-1439,-151.81,2332428,246071.15,2687,3193,0.66,0,919,0.01
1326,台化         ,20180309,-1347,-142.11,37203,3924.92,-681,-71.85,2331748,245999.41,2368,1620,0.63,0,1347,0.01
1326,台化         ,20180312,-332,-35.69,36871,3963.63,1046,112.44,2332793,250775.25,3734,2405,0.63,1,333,0
1326,台化         ,20180313,-443,-47.4,36428,3897.8,-194,-20.76,2332600,249588.2,2770,2597,0.62,0,443,0
1326,台化         ,20180314,-264,-28.38,36164,3887.63,-1202,-129.22,2331397,250625.18,3183,4095,0.62,0,264,0
1326,台化         ,20180315,-160,-17.12,36004,3852.43,-167,-17.87,2331230,249441.61,912,945,0.61,0,160,0
1326,台化         ,20180316,2141,235.51,38145,4195.95,3390,372.9,2335061,256856.71,9334,7665,0.65,2371,230,0.02
1326,台化         ,20180319,-26,-2.85,38119,4174.03,-860,-94.17,2334201,255595.01,1221,2065,0.65,11,37,0
1326,台化         ,20180320,-305,-33.7,37814,4178.45,1463,161.66,2335664,258090.87,3382,1599,0.65,20,325,0
1326,台化         ,20180321,-195,-21.65,37619,4175.71,-386,-42.85,2335278,259215.86,2584,2917,0.64,9,204,0
1326,台化         ,20180322,-611,-67.82,37008,4107.89,4814,534.35,2340229,259765.42,8259,2983,0.63,0,611,0.01
1326,台化         ,20180323,-675,-74.25,36333,3996.63,1302,143.22,2341532,257568.52,5265,3036,0.62,0,675,0.01
1326,台化         ,20180326,-130,-14.24,36203,3964.23,1260,137.97,2342792,256535.72,2220,799,0.62,9,139,0
1326,台化         ,20180327,-294,-32.37,35909,3949.99,1580,173.8,2344640,257910.4,2651,485,0.61,0,294,0
1326,台化         ,20180328,-31,-3.38,35878,3910.7,343,37.39,2345104,255616.34,1801,1305,0.61,0,31,0
1326,台化         ,20180329,-35,-3.82,35843,3906.89,1568,170.91,2346250,255741.25,4187,2428,0.61,0,35,0
1326,台化         ,20180330,-129,-14,35714,3874.97,-726,-78.77,2346012,254542.3,1757,1867,0.61,32,161,0
1326,台化         ,20180331,0,0,36229,3930.85,130,14.11,2346634,254609.79,107,0,0.62,0,0,0
1326,台化         ,20180402,-92,-9.89,36137,3884.73,-302,-32.47,2346332,252230.69,1566,1784,0.62,29,121,0
1326,台化         ,20180403,-116,-12.47,36021,3872.26,752,80.84,2347295,252334.21,2964,1877,0.61,0,116,0
1326,台化         ,20180409,-93,-10.42,35928,4023.94,5355,599.76,2353059,263542.61,7149,1310,0.61,7,100,0
1326,台化         ,20180410,-62,-6.98,35866,4034.93,2754,309.83,2355911,265039.99,4128,1214,0.61,7,69,0
1326,台化         ,20180411,-259,-28.88,35607,3970.18,45,5.02,2355871,262679.62,2288,2153,0.61,0,259,0
1326,台化         ,20180412,-275,-30.39,35332,3904.19,1452,160.45,2356988,260447.17,2677,1271,0.6,0,275,0
1326,台化         ,20180413,1,0.11,35333,3886.63,872,95.92,2357698,259346.78,1925,1216,0.6,368,367,0.01
1326,台化         ,20180416,-178,-19.49,35155,3849.47,-170,-18.61,2357570,258153.92,1125,1017,0.6,383,561,0.01
1326,台化         ,20180417,254,27.43,35409,3824.17,1447,156.28,2360064,254886.91,3420,2198,0.6,436,182,0.01
1326,台化         ,20180418,318,34.5,35727,3876.38,2822,306.19,2363162,256403.08,3170,389,0.61,381,63,0
1326,台化         ,20180419,118,12.92,35845,3925.03,4556,498.88,2367265,259215.52,4419,585,0.61,163,45,0
1326,台化         ,20180420,3,0.33,35848,3907.43,3440,374.96,2370705,258406.85,3662,311,0.61,3,0,0
1326,台化         ,20180423,4,0.43,35852,3872.02,3169,342.25,2373874,256378.39,3732,462,0.61,4,0,0
1326,台化         ,20180424,81,8.67,35933,3844.83,531,56.82,2374338,254054.17,1567,1116,0.61,140,59,0
1326,台化         ,20180425,65,6.99,35998,3869.79,3159,339.59,2377574,255589.21,5043,1708,0.61,65,0,0
1326,台化         ,20180426,10,1.09,36008,3906.87,1511,163.94,2378877,258108.15,3151,1590,0.61,10,0,0
1326,台化         ,20180427,300,32.55,36308,3939.42,783,84.96,2379715,258199.08,2048,1426,0.62,300,0,0
1326,台化         ,20180430,10,1.1,36318,3976.82,1354,148.26,2380490,260663.66,1876,587,0.62,10,0,0
1326,台化         ,20180502,0,0,36318,4013.14,1916,211.72,2382406,263255.86,3340,1428,0.62,0,0,0
1326,台化         ,20180503,220,24.09,36538,4000.91,2061,225.68,2384167,261066.29,3763,1979,0.62,295,75,0
1326,台化         ,20180504,467,50.9,37005,4033.55,1594,173.75,2385577,260027.89,3106,2033,0.63,467,0,0
1326,台化         ,20180507,1058,116.92,38063,4205.96,2742,302.99,2388320,263909.36,2418,763,0.65,1066,8,0.01
1326,台化         ,20180508,414,45.92,38477,4270.95,3083,342.21,2391361,265441.07,4025,1493,0.66,414,0,0
1326,台化         ,20180509,28,3.08,38505,4235.55,2431,267.41,2393792,263317.12,4066,1650,0.66,72,44,0
1326,台化         ,20180510,5,0.55,38510,4255.35,3112,343.88,2396904,264857.89,4746,1549,0.66,5,0,0
1326,台化         ,20180511,0,0,38510,4409.4,7524,861.5,2404427,275306.89,8314,1245,0.66,0,0,0
1326,台化         ,20180514,191,21.87,38701,4431.26,2165,247.89,2405442,275423.11,3705,1768,0.66,200,9,0
1326,台化         ,20180515,0,0,38701,4353.86,2751,309.49,2409543,271073.59,7667,4814,0.66,0,0,0
1326,台化         ,20180516,242,27.95,38943,4497.92,3605,416.38,2413148,278718.59,5690,2237,0.66,246,4,0
1326,台化         ,20180517,409,48.06,39352,4623.86,3239,380.58,2416387,283925.47,4895,2664,0.67,409,0,0
1326,台化         ,20180518,197,23.15,39549,4647.01,1418,166.62,2417805,284092.09,3231,2123,0.67,210,13,0
1326,台化         ,20180521,0,0,39549,4666.78,-133,-15.69,2417672,285285.3,2388,2510,0.67,0,0,0
1326,台化         ,20180522,-72,-8.39,39477,4599.07,-294,-34.25,2417378,281624.54,2322,2494,0.67,0,72,0
1326,台化         ,20180523,122,14.21,39599,4613.28,801,93.32,2418179,281717.85,3757,3028,0.68,122,0,0
1326,台化         ,20180524,-16,-1.87,39583,4631.21,111,12.99,2418290,282939.93,3729,2940,0.68,0,16,0
1326,台化         ,20180525,-1,-0.12,39582,4551.93,-888,-102.12,2417383,277999.04,4093,5009,0.68,0,1,0
1326,台化         ,20180528,0,0,39582,4631.09,858,100.39,2418242,282934.31,4951,3945,0.68,0,0,0
1326,台化         ,20180529,303,35.6,39885,4686.49,-272,-31.96,2418445,284167.29,3054,3869,0.68,309,6,0
1326,台化         ,20180530,-53,-6.17,39832,4640.43,-1055,-122.91,2417241,281608.58,5790,6547,0.68,0,53,0
1326,台化         ,20180531,660,75.9,40492,4656.58,-424,-48.76,2420808,278392.92,41857,43138,0.69,665,5,0.01
1326,台化         ,20180601,0,0,40492,4656.58,-2194,-252.31,2418730,278153.95,3269,5347,0.69,0,0,0
1326,台化         ,20180604,-74,-8.66,40418,4728.91,-579,-67.74,2416553,282736.7,4469,4992,0.69,0,74,0
1326,台化         ,20180605,-73,-8.43,40345,4659.85,-2690,-310.7,2413900,278805.45,2012,4592,0.69,6,79,0
1326,台化         ,20180606,-654,-75.54,39691,4584.31,-496,-57.29,2413382,278745.62,1897,1714,0.68,0,654,0.01
1326,台化         ,20180607,-322,-37.51,39369,4586.49,877,102.17,2412515,281058,4037,2793,0.67,7,329,0
1326,台化         ,20180608,-76,-8.82,39293,4557.99,945,109.62,2412220,279817.52,3520,2291,0.67,0,76,0
1326,台化         ,20180611,170,19.72,39463,4577.71,185,21.46,2411367,279718.57,3135,2976,0.67,187,17,0
1326,台化         ,20180612,-882,-102.31,38581,4475.4,-641,-74.36,2410163,279578.91,4407,4130,0.66,0,882,0.01
1326,台化         ,20180613,-546,-63.06,38035,4393.04,-3176,-366.83,2406487,277949.25,1608,4138,0.65,0,546,0
1326,台化         ,20180614,-240,-27.24,37795,4289.73,-3945,-447.76,2401970,272623.59,1392,5052,0.64,0,240,0
1326,台化         ,20180615,-2920,-328.5,34875,3923.44,-6298,-708.53,2396172,269569.35,8690,12288,0.6,0,2920,0.02
1326,台化         ,20180619,208,23.09,35083,3894.21,-2825,-313.58,2393328,265659.41,3604,6656,0.6,422,214,0.01
1326,台化         ,20180620,10,1.09,35093,4018.15,788,90.23,2393402,274044.53,3997,3330,0.6,10,0,0
1326,台化         ,20180621,0,0,35093,4053.24,-2453,-283.32,2390818,276139.48,2014,3994,0.6,0,0,0
1326,台化         ,20180622,171,20.09,35264,4143.52,-513,-60.28,2389045,280712.79,3209,4159,0.6,204,33,0
1326,台化         ,20180625,66,7.79,35330,4168.94,-2837,-334.77,2385447,281482.75,1250,4557,0.6,66,0,0
1326,台化         ,20180626,200,23.6,35530,4192.54,-1300,-153.4,2383156,281212.41,1991,3654,0.61,271,71,0
1326,台化         ,20180627,27,3.19,35557,4195.73,-793,-93.57,2382337,281115.77,3662,4660,0.61,27,0,0
1326,台化         ,20180628,105,12.34,35662,4190.29,-4812,-565.41,2377525,279359.19,1806,6805,0.61,105,0,0
1326,台化         ,20180629,437,53.1,43544,5290.6,1681,204.24,2387602,290093.64,5382,3894,0.74,445,8,0
1326,台化         ,20180702,143,17.66,43687,5395.34,-5587,-689.99,2382015,294178.85,690,6439,0.75,153,10,0
1326,台化         ,20180703,1,0.12,43688,5417.31,-4964,-615.54,2376571,294694.8,3452,8436,0.75,19,18,0
1326,台化         ,20180704,-10,-1.27,43678,5547.11,1747,221.87,2378318,302046.39,6412,5788,0.75,0,10,0
1326,台化         ,20180705,210,24.47,43888,5112.95,853,99.37,2379171,277173.42,3876,2668,0.75,300,90,0
1326,台化         ,20180706,-147,-16.61,43741,4942.73,-1938,-218.99,2377233,268627.33,3810,5893,0.75,40,187,0
1326,台化         ,20180709,535,61.79,44276,5113.88,4448,513.74,2382160,275139.48,7300,3421,0.76,535,0,0
1326,台化         ,20180710,10,1.15,44286,5070.75,64,7.33,2382224,272764.65,1746,1732,0.76,50,40,0
1326,台化         ,20180711,15,1.71,44301,5050.31,-457,-52.1,2381767,271521.44,1971,2365,0.76,15,0,0
1326,台化         ,20180712,20,2.28,44321,5052.59,1258,143.41,2383026,271664.96,2520,1291,0.76,24,4,0
1326,台化         ,20180713,-127,-14.67,44194,5104.41,857,98.98,2381759,275093.16,1868,732,0.75,0,127,0
1326,台化         ,20180716,3,0.34,44197,5060.56,286,32.75,2382045,272744.15,1077,566,0.75,3,0,0
1326,台化         ,20180717,-285,-32.06,43912,4940.1,120,13.5,2382165,267993.56,1905,1479,0.75,0,285,0
1326,台化         ,20180718,-141,-16,43771,4968.01,1689,191.7,2386687,270888.97,3326,1485,0.75,0,141,0
1326,台化         ,20180719,-4,-0.45,43767,4945.67,375,42.38,2388140,269859.82,1222,720,0.75,0,4,0
1326,台化         ,20180720,-565,-63.85,43202,4881.83,650,73.45,2389053,269962.99,2196,971,0.74,0,565,0
1326,台化         ,20180723,-84,-9.58,43118,4915.45,3132,357.05,2392459,272740.33,4972,1752,0.74,0,84,0
1326,台化         ,20180724,-13,-1.51,43105,5000.18,581,67.4,2393040,277592.64,3278,2780,0.74,91,104,0
1326,台化         ,20180725,28,3.23,43133,4981.86,2214,255.72,2392790,276367.25,3964,1767,0.74,28,0,0
1326,台化         ,20180726,12,1.42,43145,5091.11,3662,432.12,2396413,282776.73,4540,898,0.74,29,17,0
1326,台化         ,20180727,33,3.91,43178,5116.59,2477,293.52,2398890,284268.47,4542,2022,0.74,41,8,0
1326,台化         ,20180730,201,23.82,43379,5140.41,1965,232.85,2400855,284501.32,2685,835,0.74,225,24,0
1326,台化         ,20180731,15,1.81,43394,5228.98,3769,454.16,2403701,289645.97,5996,2054,0.74,33,18,0
1326,台化         ,20180801,-22,-2.64,43372,5204.64,1569,188.28,2405270,288632.4,2917,1349,0.74,58,80,0
1326,台化         ,20180802,-15,-1.77,43357,5116.13,2850,336.3,2408631,284218.46,5376,1984,0.74,0,15,0
1326,台化         ,20180803,-25,-2.96,43332,5134.84,1664,197.18,2410324,285623.39,2410,703,0.74,0,25,0
1326,台化         ,20180806,219,26.06,43551,5182.57,2598,309.16,2412876,287132.24,3339,1016,0.74,225,6,0
1326,台化         ,20180807,174,20.88,43725,5247,3338,400.56,2416357,289962.84,7201,3908,0.75,209,35,0
1326,台化         ,20180808,78,9.44,43803,5300.16,1514,183.19,2417680,292539.28,4714,3251,0.75,78,0,0
1326,台化         ,20180809,49,5.86,43852,5240.31,-151,-18.04,2417549,288897.11,1712,1907,0.75,68,19,0
1326,台化         ,20180810,9,1.07,43861,5219.46,576,68.54,2418180,287763.42,1200,577,0.75,24,15,0
1326,台化         ,20180813,0,0,43861,5131.74,842,98.51,2419343,283063.13,2301,1143,0.75,0,0,0
1326,台化         ,20180814,170,20.06,44031,5195.66,2468,291.22,2422411,285844.5,3985,1096,0.75,170,0,0
1326,台化         ,20180815,148,17.46,44179,5213.12,1704,201.07,2424256,286062.21,2573,896,0.75,163,15,0
1326,台化         ,20180816,535,63.4,44714,5298.61,1569,185.93,2425887,287467.61,2599,1507,0.76,535,0,0
1326,台化         ,20180817,11,1.3,44725,5277.55,-30,-3.54,2426034,286272.01,1366,1402,0.76,11,0,0
1326,台化         ,20180820,20,2.35,44745,5257.54,609,71.56,2426663,285132.9,3547,2940,0.76,20,0,0
1326,台化         ,20180821,210,24.99,44955,5349.65,1528,181.83,2428456,288986.26,3693,2113,0.77,242,32,0
1326,台化         ,20180822,191,22.92,45146,5417.52,1223,146.76,2430290,291634.8,2671,1031,0.77,191,0,0
1326,台化         ,20180823,1060,130.38,46206,5683.34,4448,547.1,2435801,299603.52,5115,1932,0.79,1060,0,0.01
1326,台化         ,20180824,794,96.47,47000,5710.5,1464,177.88,2437626,296171.56,3621,2865,0.8,794,0,0.01
1326,台化         ,20180827,82,10.13,47082,5814.63,3848,475.23,2441049,301469.55,4037,732,0.8,82,0,0
1326,台化         ,20180828,52,6.4,47134,5797.48,724,89.05,2441865,300349.4,2486,1725,0.8,60,8,0
1326,台化         ,20180829,65,7.93,47199,5758.28,562,68.56,2442692,298008.42,1805,1027,0.81,65,0,0
1326,台化         ,20180830,500,60.75,47699,5795.43,1533,186.26,2444219,296972.61,2736,1702,0.81,500,0,0
1326,台化         ,20180831,190,23.37,47889,5890.35,2253,277.12,2446863,300964.15,5600,3325,0.82,205,15,0
1326,台化         ,20180903,27,3.24,47916,5749.92,145,17.4,2446980,293637.6,1807,1738,0.82,27,0,0
1326,台化         ,20180904,-40,-4.86,47876,5816.93,1408,171.07,2448388,297479.14,2080,668,0.82,15,55,0
1326,台化         ,20180905,-21,-2.52,47855,5742.6,-259,-31.08,2448255,293790.6,3051,3079,0.82,0,21,0
1326,台化         ,20180906,85,10.16,47940,5728.83,102,12.19,2448464,292591.45,1833,1715,0.82,85,0,0
1326,台化         ,20180907,19,2.24,47959,5755.08,1586,190.32,2451126,294135.12,3058,1403,0.82,19,0,0
1326,台化         ,20180910,35,4.15,47994,5687.29,833,98.71,2452766,290652.77,2639,1057,0.82,35,0,0
1326,台化         ,20180911,240,28.44,48234,5715.73,378,44.79,2455389,290963.6,2621,2656,0.82,240,0,0
1326,台化         ,20180912,420,49.56,48654,5741.17,1001,118.12,2455918,289798.32,2206,2012,0.83,420,0,0
1326,台化         ,20180913,346,41.69,49000,5904.5,4614,555.99,2460586,296500.61,5921,1553,0.84,346,0,0
1326,台化         ,20180914,841,102.18,49841,6055.68,4051,492.2,2464578,299446.23,4647,1514,0.85,856,15,0.01
1326,台化         ,20180917,368,44.53,50209,6075.29,1925,232.93,2466468,298442.63,2472,926,0.86,368,0,0
1326,台化         ,20180918,378,45.74,50587,6121.03,1402,169.64,2467809,298604.89,2702,1739,0.86,378,0,0
1326,台化         ,20180919,348,42.46,50935,6214.07,2021,246.56,2469998,301339.76,2238,398,0.87,348,0,0
1326,台化         ,20180920,929,113.34,51864,6327.41,1845,225.09,2473483,301764.93,2285,1587,0.88,934,5,0.01
1326,台化         ,20180921,1191,152.45,53055,6791.04,8223,1052.54,2481749,317663.87,11503,4532,0.91,1377,186,0.01
1326,台化         ,20180925,90,11.39,53145,6722.84,-523,-66.16,2481348,313890.52,2056,2553,0.91,114,24,0
1326,台化         ,20180926,-64,-8,53081,6635.13,-446,-55.75,2480835,310104.38,2496,2865,0.91,70,134,0
1326,台化         ,20180927,351,44.75,53432,6812.58,3681,469.33,2484377,316758.07,6548,3357,0.91,363,12,0
1326,台化         ,20180928,687,87.94,47070,6024.96,1786,228.61,2479167,317333.38,4385,3213,0.8,687,0,0.01
1326,台化         ,20181001,164,21.07,47234,6069.57,590,75.82,2479757,318648.77,1912,1538,0.81,164,0,0
1326,台化         ,20181002,36,4.57,47270,6003.29,-1982,-251.71,2477852,314687.2,2896,4780,0.81,41,5,0
1326,台化         ,20181003,3,0.37,47273,5885.49,-307,-38.22,2477780,308483.61,1738,1819,0.81,3,0,0
1326,台化         ,20181004,58,7.19,47331,5869.04,-1118,-138.63,2476546,307091.7,2167,3394,0.81,58,0,0
1326,台化         ,20181005,-764,-92.02,46567,5611.32,-1393,-167.86,2475240,298266.42,3362,3920,0.79,18,782,0.01
1326,台化         ,20181008,-515,-62.57,46052,5595.32,695,84.44,2472134,300364.28,2420,1579,0.79,18,533,0
1326,台化         ,20181009,-71,-8.8,45981,5701.64,729,90.4,2472812,306628.69,2944,2123,0.78,348,419,0.01
1326,台化         ,20181011,-915,-104.3,45066,5137.52,-10710,-1220.94,2462919,280772.77,4768,13701,0.77,168,1083,0.01
1326,台化         ,20181012,560,66.36,45626,5406.68,-1891,-224.08,2463726,291951.53,5645,6259,0.78,970,410,0.01
1326,台化         ,20181015,-1093,-126.24,44533,5143.56,-6113,-706.05,2457829,283879.25,1709,6297,0.76,0,1093,0.01
1326,台化         ,20181016,-320,-36.96,44213,5106.6,-3569,-412.22,2458383,283943.24,1176,2761,0.75,19,339,0
1326,台化         ,20181017,-37,-4.24,44176,5058.15,-2773,-317.51,2457577,281392.57,2216,3172,0.75,13,50,0
1326,台化         ,20181018,23,2.62,44199,5038.69,40,4.56,2456509,280042.03,2966,2729,0.75,38,15,0
1326,台化         ,20181019,67,7.6,44266,5024.19,942,106.92,2457683,278947.02,4423,3324,0.76,137,70,0
1326,台化         ,20181022,60,6.87,44326,5075.33,291,33.32,2457969,281437.45,1378,1162,0.76,265,205,0
1326,台化         ,20181023,-87,-9.84,44239,4999.01,-1498,-169.27,2457632,277712.42,3089,4289,0.75,31,118,0
1326,台化         ,20181024,-554,-62.05,43685,4892.72,-289,-32.37,2458952,275402.62,4676,4551,0.75,3,557,0
1326,台化         ,20181025,-300,-32.26,43385,4663.89,-1474,-158.46,2459803,264428.82,4454,5706,0.74,75,375,0
1326,台化         ,20181026,-225,-24.19,43160,4639.7,406,43.65,2460244,264476.23,4330,3792,0.74,40,265,0
1326,台化         ,20181029,-734,-79.64,42426,4603.22,-521,-56.53,2459313,266835.46,1543,1436,0.72,1,735,0.01
1326,台化         ,20181030,-665,-71.82,41761,4510.19,-859,-92.77,2458373,265504.28,2550,2828,0.71,7,672,0.01
1326,台化         ,20181031,-144,-16.13,41617,4661.1,-723,-80.98,2457650,275256.8,4885,5399,0.71,4,148,0
1326,台化         ,20181101,-849,-93.39,40768,4484.48,-3060,-336.6,2454612,270007.32,1714,3917,0.7,17,866,0.01
1326,台化         ,20181102,-1411,-153.77,39357,4289.91,-3071,-334.74,2451533,267217.1,2557,4285,0.67,1,1412,0.01
1326,台化         ,20181105,-517,-57.65,38840,4330.66,1320,147.18,2452946,273503.48,4523,2575,0.66,0,517,0
1326,台化         ,20181106,0,0,38840,4272.4,-615,-67.65,2452554,269780.94,2136,2576,0.66,0,0,0
1326,台化         ,20181107,-110,-12.16,38730,4279.67,-483,-53.37,2452291,270978.16,2387,2549,0.66,23,133,0
1326,台化         ,20181108,-157,-17.27,38573,4243.03,-522,-57.42,2451764,269694.04,2917,3282,0.66,3,160,0
1326,台化         ,20181109,-900,-96.75,37673,4049.85,-4935,-530.51,2446722,263022.62,1338,5474,0.64,3,903,0.01
1326,台化         ,20181112,-229,-24.62,37444,4025.23,-431,-46.33,2446536,263002.62,2026,2098,0.64,8,237,0
1326,台化         ,20181113,-30,-3.2,37414,3984.59,-1417,-150.91,2444885,260380.25,2219,3633,0.64,0,30,0
1326,台化         ,20181114,-1632,-172.99,35782,3792.89,-1897,-201.08,2442689,258925.03,2008,2205,0.61,3,1635,0.01
1326,台化         ,20181115,-3,-0.32,35779,3846.24,969,104.17,2441197,262428.68,2679,1728,0.61,3,6,0
1326,台化         ,20181116,6,0.64,35785,3864.78,-94,-10.15,2443595,263908.26,1900,1997,0.61,6,0,0
1326,台化         ,20181119,-10,-1.08,35775,3863.7,-413,-44.6,2443123,263857.28,2375,2837,0.61,5,15,0
1326,台化         ,20181120,-193,-20.76,35582,3825.07,-150,-16.13,2442895,262611.21,2214,2250,0.61,15,208,0
1326,台化         ,20181121,-260,-27.82,35322,3779.45,-19,-2.03,2442671,261365.8,1656,1535,0.6,6,266,0
1326,台化         ,20181122,-162,-17.41,35160,3779.7,1546,166.2,2444169,262748.17,3066,1427,0.6,9,171,0
1326,台化         ,20181123,6,0.64,35166,3762.76,10,1.07,2444172,261526.4,1811,1815,0.6,6,0,0
1326,台化         ,20181126,-118,-12.57,35048,3732.61,-558,-59.43,2443601,260243.51,2261,2744,0.6,0,118,0
1326,台化         ,20181127,-528,-55.18,34520,3607.34,-4429,-462.83,2439220,254898.49,1896,5740,0.59,0,528,0
1326,台化         ,20181128,-1218,-127.31,33302,3480.06,-2705,-282.67,2436145,254577.15,3234,5052,0.57,6,1224,0.01
1326,台化         ,20181129,-189,-19.75,33113,3460.31,-1536,-160.51,2434643,254420.19,1699,3038,0.56,11,200,0
1326,台化         ,20181130,171,18.21,33284,3544.75,699,74.44,2434821,259308.44,6737,6265,0.57,171,0,0
1326,台化         ,20181203,-68,-7.31,33216,3570.72,-29,-3.12,2434792,261740.14,1687,1805,0.57,12,80,0
1326,台化         ,20181204,27,2.89,33243,3557,-1281,-137.07,2433510,260385.57,4056,5530,0.57,27,0,0
1326,台化         ,20181205,-10,-1.06,33233,3522.7,-2276,-241.26,2431235,257710.91,1823,4024,0.57,0,10,0
1326,台化         ,20181206,23,2.43,33256,3508.51,-1688,-178.08,2429401,256301.81,2155,3782,0.57,23,0,0
1326,台化         ,20181207,11,1.16,33267,3509.67,626,66.04,2430027,256367.85,2268,1958,0.57,11,0,0
1326,台化         ,20181210,15,1.55,33282,3494.61,-1417,-148.79,2428681,255011.51,551,2067,0.57,15,0,0
1326,台化         ,20181211,-222,-23.2,33060,3454.77,-1662,-173.68,2427019,253623.49,1323,2841,0.56,39,261,0
1326,台化         ,20181212,-2,-0.21,33058,3487.62,-827,-87.25,2425967,255939.52,2286,3324,0.56,0,2,0
1326,台化         ,20181213,-5,-0.53,33053,3487.09,-166,-17.51,2425801,255922.01,2109,2324,0.56,0,5,0
1326,台化         ,20181214,-92,-9.66,32961,3460.91,-1856,-194.88,2423859,254505.2,1630,3220,0.56,5,97,0
1326,台化         ,20181217,-83,-8.76,32878,3468.63,305,32.18,2424079,255740.33,1979,1603,0.56,0,83,0
1326,台化         ,20181218,-168,-17.72,32710,3450.91,-584,-61.61,2423495,255678.72,2832,3391,0.56,0,168,0
1326,台化         ,20181219,-115,-12.19,32595,3455.07,297,31.48,2423673,256909.34,2675,2213,0.56,0,115,0
1326,台化         ,20181220,2,0.21,32597,3455.28,303,32.12,2423975,256941.35,2172,1826,0.56,2,0,0
1326,台化         ,20181221,148,15.54,32745,3438.23,-56,-5.88,2422919,254406.5,3387,3606,0.56,194,46,0
1326,台化         ,20181222,55,5.78,32800,3444,-65,-6.83,2422854,254399.67,0,108,0.56,55,0,0
1326,台化         ,20181224,-781,-80.44,32019,3297.96,-783,-80.65,2421969,249462.81,2541,2325,0.55,169,950,0.01
1326,台化         ,20181225,-7,-0.72,32012,3249.22,-196,-19.89,2421864,245819.2,1083,932,0.55,137,144,0
1326,台化         ,20181226,-412,-41.2,31600,3160,-262,-26.2,2421373,242137.3,167,110,0.54,63,475,0
1326,台化         ,20181227,-57,-5.84,31543,3233.16,1221,125.15,2422604,248316.91,2521,974,0.54,15,72,0
1326,台化         ,20181228,-3,-0.32,39806,4179.63,948,99.54,2432563,255419.12,3140,2143,0.68,0,3,0
1326,台化         ,20190102,-750,-74.78,39056,3893.88,-4180,-416.75,2428383,242109.79,1137,4500,0.67,12,762,0.01
1326,台化         ,20190103,-515,-51.5,38541,3854.1,-1512,-151.2,2426786,242678.6,1340,2549,0.66,0,515,0
1326,台化         ,20190104,-86,-8.58,38455,3837.81,219,21.86,2426974,242212.01,2178,2206,0.66,60,146,0
1326,台化         ,20190107,161,16.82,38616,4035.37,3010,314.55,2429838,253918.07,4464,1558,0.66,161,0,0
1326,台化         ,20190108,0,0,38616,4131.91,-1758,-188.11,2428108,259807.56,1404,3113,0.66,0,0,0
1326,台化         ,20190109,271,29.4,38887,4219.24,-2828,-306.84,2425279,263142.77,4479,7933,0.66,399,128,0
1326,台化         ,20190110,326,34.88,39213,4195.79,-3943,-421.9,2422387,259195.41,2410,6750,0.67,326,0,0
1326,台化         ,20190111,-103,-10.92,39110,4145.66,-1499,-158.89,2420994,256625.36,4191,5625,0.67,8,111,0
1326,台化         ,20190114,-68,-7.21,39042,4138.45,-1613,-170.98,2419381,256454.39,1429,2972,0.67,0,68,0
1326,台化         ,20190115,311,32.94,39353,4171.42,-1614,-171.08,2418020,256310.12,2817,4938,0.67,345,34,0
1326,台化         ,20190116,-36,-3.8,39317,4147.94,-2085,-219.97,2415782,254865,1953,4139,0.67,0,36,0
1326,台化         ,20190117,-46,-4.9,39271,4182.36,52,5.54,2415622,257263.74,3552,3559,0.67,0,46,0
1326,台化         ,20190118,-77,-8.2,39194,4174.16,533,56.76,2416155,257320.51,4784,4466,0.67,0,77,0
1326,台化         ,20190121,-232,-25.06,38962,4207.9,741,80.03,2416989,261034.81,1821,926,0.66,0,232,0
1326,台化         ,20190122,27,2.92,38989,4210.81,-186,-20.09,2416889,261024.01,1598,1802,0.67,27,0,0
1326,台化         ,20190123,-13,-1.38,38976,4150.94,-1101,-117.26,2415772,257279.72,1451,2257,0.66,154,167,0
1326,台化         ,20190124,-13,-1.37,38963,4091.11,-3087,-324.14,2412603,253323.32,2468,5572,0.66,14,27,0
1326,台化         ,20190125,-62,-6.67,38901,4181.86,1216,130.72,2413819,259485.54,3577,2301,0.66,88,150,0
1326,台化         ,20190128,0,0,38901,4181.86,-127,-13.65,2409733,259046.3,2385,2545,0.66,0,0,0
1326,台化         ,20190129,0,0,38901,4123.51,-1236,-131.02,2408556,255306.94,5781,7054,0.66,0,0,0
1326,台化         ,20190130,-142,-15.12,38759,4127.83,-797,-84.88,2405502,256185.96,3819,4595,0.66,0,142,0
1326,台化         ,20190211,-732,-75.76,38027,3935.79,-4765,-493.18,2400712,248473.69,3393,7536,0.65,3,735,0.01
1326,台化         ,20190212,-316,-33.02,37711,3940.8,-1624,-169.71,2399033,250698.95,2796,4102,0.64,0,316,0
1326,台化         ,20190213,-136,-14.08,37575,3889.01,-4395,-454.88,2394642,247845.45,2582,6729,0.64,3,139,0
1326,台化         ,20190214,0,0,37575,3907.8,-3595,-373.88,2391043,248668.47,1831,5470,0.64,0,0,0
1326,台化         ,20190215,0,0,37575,3907.8,-4172,-433.89,2386871,248234.58,2106,6310,0.64,0,0,0
1326,台化         ,20190218,0,0,37575,3907.8,-808,-84.03,2385980,248141.92,3660,4542,0.64,0,0,0
1326,台化         ,20190219,-135,-14.11,37440,3912.48,-1307,-136.58,2384678,249198.85,1440,2669,0.64,0,135,0
1326,台化         ,20190220,0,0,37440,3949.92,-1022,-107.82,2383656,251475.71,3271,4324,0.64,0,0,0
1326,台化         ,20190221,0,0,37440,3949.92,-3074,-324.31,2380583,251151.51,2162,5391,0.64,0,0,0
1326,台化         ,20190222,0,0,37440,3968.64,-927,-98.26,2379656,252243.54,2650,3563,0.64,0,0,0
1326,台化         ,20190225,-6,-0.61,37434,4005.44,56,5.99,2379877,254646.84,3404,3469,0.64,0,6,0
1326,台化         ,20190226,-100,-10.6,37334,3957.4,-3116,-330.3,2376487,251907.62,2487,5469,0.64,0,100,0
1326,台化         ,20190227,-71,-7.49,37263,3931.25,-788,-83.13,2375266,250590.56,3814,4496,0.64,0,71,0
1326,台化         ,20190304,-6,-0.61,37257,3967.87,-1859,-197.98,2373428,252770.08,2465,4291,0.64,0,6,0
1326,台化         ,20190305,7,0.75,37264,3968.62,-2107,-224.4,2371816,252598.4,826,2775,0.64,7,0,0
1326,台化         ,20190306,0,0,37264,4005.88,-696,-74.82,2371588,254945.71,1650,2043,0.64,0,0,0
1326,台化         ,20190307,160,17.36,37424,4060.5,-1629,-176.75,2370099,257155.74,1515,3164,0.64,160,0,0
1326,台化         ,20190308,240,26.04,37664,4086.54,-1490,-161.66,2368659,256999.5,229,1909,0.64,240,0,0
1326,台化         ,20190311,12,1.3,37676,4069.01,-1503,-162.32,2367197,255657.28,973,2447,0.64,12,0,0
1326,台化         ,20190312,10,1.09,37686,4088.93,-459,-49.8,2366803,256798.13,1520,1924,0.64,10,0,0
1326,台化         ,20190313,90,9.72,37776,4079.81,-1106,-119.45,2365932,255520.66,456,1697,0.64,90,0,0
1326,台化         ,20190314,5,0.54,37781,4061.46,-1046,-112.44,2365045,254242.34,577,1625,0.64,5,0,0
1326,台化         ,20190315,22,2.38,37803,4082.72,-214,-23.11,2364770,255395.16,3933,4229,0.64,101,79,0
1326,台化         ,20190318,46,5.04,37849,4144.47,-230,-25.19,2364577,258921.18,997,1236,0.65,57,11,0
1326,台化         ,20190319,208,22.78,38057,4167.24,-1342,-146.95,2363513,258804.67,976,2248,0.65,208,0,0
1326,台化         ,20190320,126,13.67,38183,4142.86,-1561,-169.37,2361947,256271.25,1080,2772,0.65,126,0,0
1326,台化         ,20190321,65,7.12,38248,4188.16,167,18.29,2362350,258677.33,1163,1055,0.65,65,0,0
1326,台化         ,20190322,-11,-1.17,38237,4167.83,-1541,-167.97,2360781,257325.13,1515,3073,0.65,60,71,0
1326,台化         ,20190325,3,0.33,38240,4149.04,-373,-40.47,2360386,256101.88,1218,1615,0.65,6,3,0
1326,台化         ,20190326,0,0,38240,4168.16,-1049,-114.34,2359137,257145.93,1203,2526,0.65,0,0,0
1326,台化         ,20190327,-3,-0.33,38237,4206.07,-907,-99.77,2358112,259392.32,1677,2699,0.65,0,3,0
1326,台化         ,20190328,0,0,38237,4186.95,-1947,-213.2,2356183,258002.04,1466,3395,0.65,0,0,0
1326,台化         ,20190329,8,0.9,36848,4126.98,1240,138.88,2356052,263877.82,4534,3276,0.63,8,0,0
1326,台化         ,20190401,-1,-0.1,36847,4053.17,-1961,-215.71,2354191,258961.01,1622,3483,0.63,0,1,0
1326,台化         ,20190402,-53,-5.83,36794,4047.34,-1360,-149.6,2352732,258800.52,449,1906,0.63,4,57,0
1326,台化         ,20190403,-8,-0.87,36786,4009.67,-1854,-202.09,2350892,256247.23,498,2278,0.63,0,8,0
1326,台化         ,20190408,-633,-69,36153,3940.68,-2912,-317.41,2347982,255930.04,1574,5094,0.62,0,633,0.01
1326,台化         ,20190409,55,6,36208,3946.67,-1647,-179.52,2346985,255821.37,1208,3315,0.62,57,2,0
1326,台化         ,20190410,10,1.09,36218,3929.65,-2006,-217.65,2344979,254430.22,1591,4283,0.62,10,0,0
1326,台化         ,20190411,-83,-9.13,36135,3974.85,-2218,-243.98,2342761,257703.71,782,2583,0.62,5,88,0
1326,台化         ,20190412,0,0,36135,3920.65,-1985,-215.37,2340778,253974.41,1872,3834,0.62,5,5,0
1326,台化         ,20190415,-85,-9.22,36050,3911.43,-347,-37.65,2340531,253947.61,1353,1600,0.62,0,85,0
1326,台化         ,20190416,-145,-15.73,35905,3895.69,-2196,-238.27,2338332,253709.02,843,2807,0.61,0,145,0
1326,台化         ,20190417,-3,-0.33,35902,3895.37,-3978,-431.61,2334924,253339.25,2059,5986,0.61,0,3,0
1326,台化         ,20190418,-44,-4.8,35858,3908.52,-2518,-274.46,2332406,254232.25,1994,4207,0.61,0,44,0
1326,台化         ,20190419,0,0,35858,3890.59,-2424,-263,2329982,252803.05,562,2962,0.61,0,0,0
1326,台化         ,20190422,-200,-21.76,35658,3886.72,-765,-83.39,2329217,253884.65,233,788,0.61,0,200,0
1326,台化         ,20190423,7,0.76,35665,3887.49,-1780,-194.02,2327438,253690.74,1044,2827,0.61,7,0,0
1326,台化         ,20190424,0,0,35665,3869.65,-2431,-263.76,2324998,252262.28,1523,3729,0.61,0,0,0
1326,台化         ,20190425,-36,-3.94,35629,3901.38,-603,-66.03,2324395,254521.25,1348,1898,0.61,0,36,0
1326,台化         ,20190426,0,0,35629,3937,834,92.16,2325229,256937.8,2104,1266,0.61,0,0,0
1326,台化         ,20190429,129,14.32,35758,3969.14,347,38.52,2325586,258140.05,1782,1571,0.61,143,14,0
1326,台化         ,20190430,-6,-0.67,35752,3968.47,-852,-94.57,2323801,257941.91,2779,3633,0.61,0,6,0
1326,台化         ,20190502,264,29.83,36016,4069.81,1350,152.55,2325816,262817.21,4670,3454,0.61,271,7,0
1326,台化         ,20190503,14,1.56,36030,4035.36,-2595,-290.64,2323042,260180.7,1065,3734,0.61,23,9,0
1326,台化         ,20190506,-1,-0.11,36029,3999.22,-1047,-116.22,2322466,257793.73,1974,2987,0.61,0,1,0
1326,台化         ,20190507,-118,-12.89,35911,3932.25,-3331,-364.74,2319510,253986.35,1540,4738,0.61,0,118,0
1326,台化         ,20190508,-53,-5.7,35858,3890.59,-3081,-334.29,2316933,251387.23,1026,4251,0.61,0,53,0
1326,台化         ,20190509,-28,-2.97,35830,3797.98,-6374,-675.64,2310344,244896.46,1418,7909,0.61,0,28,0
1326,台化         ,20190510,-503,-53.82,35327,3779.99,-2003,-214.32,2308333,246991.63,801,2357,0.6,7,510,0
1326,台化         ,20190513,-46,-4.9,35281,3757.43,-2015,-214.6,2305814,245569.19,691,2926,0.6,13,59,0
1326,台化         ,20190514,-221,-23.43,35060,3716.36,-3722,-394.53,2302757,244092.24,1228,5478,0.6,0,221,0
1326,台化         ,20190515,-38,-4.03,35022,3712.33,-3667,-388.7,2298926,243686.16,536,4037,0.6,0,38,0
1326,台化         ,20190516,-113,-11.98,34909,3700.35,516,54.7,2299442,243740.85,1128,2830,0.6,12,125,0
1326,台化         ,20190517,4,0.42,34913,3700.78,-711,-75.37,2298485,243639.41,540,2044,0.6,4,0,0
1326,台化         ,20190520,13,1.39,34926,3737.08,1148,122.84,2299661,246063.73,2601,2614,0.6,13,0,0
1326,台化         ,20190521,0,0,34926,3754.55,-6,-0.65,2299786,247227,3551,4104,0.6,0,0,0
1326,台化         ,20190522,11,1.18,34937,3738.26,-2675,-286.23,2297135,245793.45,718,3517,0.6,11,0,0
1326,台化         ,20190523,-19,-2.02,34918,3718.77,-518,-55.17,2296617,244589.71,951,1782,0.6,30,49,0
1326,台化         ,20190524,-279,-29.57,34639,3671.73,-1761,-186.67,2294966,243266.4,1597,3352,0.59,11,290,0
1326,台化         ,20190527,-20,-2.13,34619,3686.92,216,23,2295182,244436.88,699,712,0.59,0,20,0
1326,台化         ,20190528,-102,-10.86,34517,3676.06,-589,-62.73,2293858,244295.88,9193,10032,0.59,13,115,0
1326,台化         ,20190529,13,1.38,34530,3677.45,-109,-11.61,2293702,244279.26,1082,1330,0.59,13,0,0
1326,台化         ,20190530,-2,-0.21,34528,3694.5,-297,-31.78,2293407,245394.55,2308,2760,0.59,0,2,0
1326,台化         ,20190531,-43,-4.62,34485,3707.14,-392,-42.14,2285395,245679.96,2887,3276,0.59,0,43,0
1326,台化         ,20190603,-3,-0.32,34482,3672.33,-1910,-203.42,2283003,243139.82,2398,4436,0.59,0,3,0
1326,台化         ,20190604,-22,-2.34,34460,3669.99,-1435,-152.83,2281224,242950.36,3363,4843,0.59,0,22,0
1326,台化         ,20190605,0,0,34460,3704.45,-465,-49.99,2280250,245126.88,2538,2657,0.59,0,0,0
1326,台化         ,20190606,0,0,34460,3704.45,-69,-7.42,2279295,245024.21,2260,2762,0.59,0,0,0
1326,台化         ,20190610,-14,-1.51,34446,3702.95,-417,-44.83,2278233,244910.05,1506,2156,0.59,0,14,0
1326,台化         ,20190611,-125,-13.5,34321,3706.67,-610,-65.88,2275671,245772.47,1669,2353,0.59,0,125,0
1326,台化         ,20190612,-9,-0.97,34312,3757.16,580,63.51,2273085,248902.81,3065,1945,0.59,24,33,0
1326,台化         ,20190613,14,1.55,34326,3793.02,784,86.63,2271234,250971.36,2256,1670,0.59,14,0,0
1326,台化         ,20190614,300,33.15,34626,3826.17,-57,-6.3,2268066,250621.29,1353,2032,0.59,300,0,0
1326,台化         ,20190617,-119,-13.16,34507,3813.02,544,60.11,2267060,250510.13,2221,1879,0.59,9,128,0
1326,台化         ,20190618,135,15.05,34642,3862.58,938,104.59,2266202,252681.52,1566,1035,0.59,281,146,0
1326,台化         ,20190619,-114,-12.77,34528,3867.14,1875,210,2266144,253808.13,4008,3441,0.59,46,160,0
1326,台化         ,20190620,-318,-35.3,34210,3797.31,-1397,-155.07,2264812,251394.13,2270,4232,0.58,20,338,0
1326,台化         ,20190621,-149,-16.39,34061,3746.71,-2516,-276.76,2262296,248852.56,5274,7908,0.58,19,168,0
1326,台化         ,20190624,-70,-7.74,33991,3773,1870,207.57,2263863,251288.79,3312,3382,0.58,136,206,0
1326,台化         ,20190625,-5,-0.55,33986,3738.46,1524,167.64,2265392,249193.12,2940,3074,0.58,0,5,0
1326,台化         ,20190626,-129,-13.16,33857,3453.41,143,14.59,2265598,231091,6205,2969,0.58,33,162,0
1326,台化         ,20190627,18,1.87,33875,3523,189,19.66,2265782,235641.33,4597,4055,0.58,19,1,0
1326,台化         ,20190628,-2,-0.21,48920,5038.76,-668,-68.8,2282007,235046.72,1205,1846,0.83,0,2,0
1326,台化         ,20190701,-132,-13.46,48788,4976.38,-2824,-288.05,2279199,232478.3,651,3144,0.83,2,134,0
1326,台化         ,20190702,-445,-44.72,48343,4858.47,-2310,-232.16,2276900,228828.45,965,2890,0.82,1,446,0
1326,台化         ,20190703,-417,-41.91,47926,4816.56,-1190,-119.6,2275815,228719.41,980,1722,0.82,0,417,0
1326,台化         ,20190704,-382,-38.16,47544,4754.4,-715,-71.5,2275105,227510.5,540,1170,0.81,0,382,0
1326,台化         ,20190705,-206,-20.6,47338,4733.8,-58,-5.8,2275047,227504.7,1194,1075,0.81,10,216,0
1326,台化         ,20190708,-180,-17.82,47158,4668.64,-2521,-249.58,2272460,224973.54,1720,4058,0.8,0,180,0
1326,台化         ,20190709,-528,-52.01,46630,4593.06,-2099,-206.75,2270361,223630.56,585,2155,0.8,21,549,0
1326,台化         ,20190710,19,1.88,46649,4604.26,-1307,-129,2271242,224171.59,858,2580,0.8,19,0,0
1326,台化         ,20190711,4,0.39,46653,4585.99,-1683,-165.44,2269685,223110.04,1782,3063,0.8,15,11,0
1326,台化         ,20190712,-242,-23.81,46411,4566.84,-2971,-292.35,2266732,223046.43,1185,3951,0.79,0,242,0
1326,台化         ,20190715,-82,-8.02,46329,4530.98,-2132,-208.51,2264743,221491.87,1744,3741,0.79,1,83,0
1326,台化         ,20190716,33,3.23,46362,4538.84,-821,-80.38,2265292,221772.09,590,1425,0.79,33,0,0
1326,台化         ,20190717,-70,-6.8,46292,4494.95,-983,-95.45,2264895,219921.3,2305,3184,0.79,0,70,0
1326,台化         ,20190718,-242,-23.38,46050,4457.64,-1517,-146.85,2265229,219274.17,885,2031,0.79,15,257,0
1326,台化         ,20190719,-345,-33.29,45705,4410.53,-985,-95.05,2264466,218520.97,1511,2164,0.78,0,345,0
1326,台化         ,20190722,-44,-4.25,45661,4406.29,-1364,-131.63,2262904,218370.24,1362,2646,0.78,16,60,0
1326,台化         ,20190723,-133,-12.82,45528,4388.9,-1306,-125.9,2261739,218031.64,867,1968,0.78,22,155,0
1326,台化         ,20190724,-63,-6.06,45465,4373.73,-2049,-197.11,2257247,217147.16,1012,2535,0.78,8,71,0
1326,台化         ,20190725,4,0.38,45469,4369.57,-1428,-137.23,2256016,216803.14,1324,2077,0.78,63,59,0
1326,台化         ,20190726,-172,-16.51,45297,4348.51,-3867,-371.23,2252266,216217.54,621,1707,0.77,1,173,0
1326,台化         ,20190729,45,4.29,45342,4321.09,-4023,-383.39,2249761,214402.22,1874,2536,0.77,45,0,0
1326,台化         ,20190730,24,2.28,45366,4314.31,1063,101.09,2251017,214071.72,2010,1004,0.77,24,0,0
1326,台化         ,20190731,23,2.19,45389,4311.96,-1101,-104.6,2251396,213882.62,2410,3282,0.77,37,14,0
1326,台化         ,20190801,-64,-6.01,45325,4256.02,-2479,-232.78,2249361,211215,1659,3997,0.77,24,88,0
1326,台化         ,20190802,0,0,45325,4169.9,-3873,-356.32,2245851,206618.29,2674,6496,0.77,0,0,0
1326,台化         ,20190805,40,3.62,45365,4110.07,-1584,-143.51,2244397,203342.37,3357,5024,0.77,40,0,0
1326,台化         ,20190806,133,11.86,45498,4058.42,624,55.66,2245118,200264.53,4302,3817,0.78,155,22,0
1326,台化         ,20190807,-2,-0.18,45496,4053.69,-1210,-107.81,2245353,200060.95,3894,4853,0.78,42,44,0
1326,台化         ,20190808,18,1.6,45514,4032.54,-3178,-281.57,2242221,198660.78,2448,5690,0.78,18,0,0
1326,台化         ,20190812,15,1.29,45529,3920.05,-2762,-237.81,2234025,192349.55,3114,5431,0.78,24,9,0
1326,台化         ,20190813,53,4.59,45582,3933.73,-1912,-165.01,2232492,192664.06,2771,4682,0.78,103,50,0
1326,台化         ,20190814,-46,-3.98,45536,3938.86,-2564,-221.79,2230884,192971.47,1647,3898,0.78,3,49,0
1326,台化         ,20190815,27,2.3,45563,3886.52,-3309,-282.26,2227830,190033.9,1565,4563,0.78,27,0,0
1326,台化         ,20190816,19,1.64,45582,3929.17,-3665,-315.92,2224944,191790.17,2130,5516,0.78,28,9,0
1326,台化         ,20190819,24,2.07,45606,3931.24,-1878,-161.88,2223269,191645.79,1411,3322,0.78,25,1,0
1326,台化         ,20190820,5,0.44,45611,3972.72,-1069,-93.11,2219640,193330.64,2415,3490,0.78,5,0,0
1326,台化         ,20190821,-175,-15.21,45436,3948.39,-2173,-188.83,2218643,192800.08,1001,2622,0.78,15,190,0
1326,台化         ,20190822,305,26.44,45741,3965.74,-726,-62.94,2217817,192284.73,1821,2846,0.78,305,0,0
1326,台化         ,20190823,57,4.96,45798,3984.43,-479,-41.67,2217375,192911.63,953,1453,0.78,57,0,0
1326,台化         ,20190826,33,2.82,45831,3923.13,-2264,-193.8,2215194,189620.61,2648,4738,0.78,50,17,0
1326,台化         ,20190827,119,10.17,45950,3928.73,-2533,-216.57,2212666,189182.94,6206,8853,0.78,121,2,0
1326,台化         ,20190828,7,0.6,45957,3910.94,-2316,-197.09,2210665,188127.59,1600,3900,0.78,57,50,0
1326,台化         ,20190829,-75,-6.44,45882,3941.26,-41,-3.52,2210633,189893.37,1606,1536,0.78,30,105,0
1326,台化         ,20190830,-94,-8.28,45788,4033.92,1106,97.44,2211843,194863.37,3503,2205,0.78,0,94,0
1326,台化         ,20190902,-25,-2.19,45763,4004.26,-512,-44.8,2211380,193495.75,785,1223,0.78,25,50,0
1326,台化         ,20190903,-34,-2.95,45729,3969.28,-2485,-215.7,2211532,191960.98,1377,3801,0.78,17,51,0
1326,台化         ,20190904,52,4.56,45781,4010.42,368,32.24,2212200,193788.72,2019,2038,0.78,52,0,0
1326,台化         ,20190905,369,33.03,46150,4130.43,855,76.52,2213053,198068.24,2960,2413,0.79,369,0,0
1326,台化         ,20190906,39,3.48,46189,4120.06,-212,-18.91,2214692,197550.53,1682,1855,0.79,66,27,0
1326,台化         ,20190909,27,2.39,46216,4085.49,-644,-56.93,2214224,195737.4,1146,1787,0.79,27,0,0
1326,台化         ,20190910,4,0.35,46220,4085.85,351,31.03,2215276,195830.4,2073,1501,0.79,4,0,0
1326,台化         ,20190911,14,1.24,46234,4091.71,70,6.2,2215999,196115.91,3519,2811,0.79,14,0,0
1326,台化         ,20190912,83,7.4,46317,4131.48,993,88.58,2217103,197765.59,4356,3305,0.79,83,0,0
1326,台化         ,20190916,224,20.52,46541,4258.5,18,1.65,2216586,202817.62,3483,3896,0.79,246,22,0
1326,台化         ,20190917,12,1.08,46553,4194.43,-1291,-116.32,2214454,199522.31,1276,2335,0.79,12,0,0
1326,台化         ,20190918,15,1.38,46568,4205.09,1656,149.54,2218999,200375.61,3965,1935,0.79,21,6,0
1326,台化         ,20190919,80,7.18,46648,4188.99,-83,-7.45,2220627,199412.3,820,954,0.8,106,26,0
1326,台化         ,20190920,701,63.44,47349,4285.08,591,53.49,2221273,201025.21,5498,5571,0.81,757,56,0.01
1326,台化         ,20190923,0,0,47349,4242.47,609,54.57,2220947,198996.85,2489,1819,0.81,0,0,0
1326,台化         ,20190924,-19,-1.67,47330,4202.9,-118,-10.48,2223635,197458.79,2557,2630,0.81,5,24,0
1326,台化         ,20190925,166,14.66,47496,4193.9,113,9.98,2225935,196550.06,1950,1847,0.81,178,12,0
1326,台化         ,20190926,55,4.83,47551,4174.98,205,18,2226238,195463.7,2189,2035,0.81,100,45,0
1326,台化         ,20190927,-42,-3.64,32370,2806.48,-833,-72.22,2210315,191634.31,1211,1838,0.55,0,42,0
1326,台化         ,20191001,6,0.52,32376,2823.19,801,69.85,2210414,192748.1,3448,2550,0.55,6,0,0
1326,台化         ,20191002,-44,-3.83,32332,2816.12,107,9.32,2210372,192523.4,1329,1167,0.55,20,64,0
1326,台化         ,20191003,11,0.94,32343,2794.44,-1297,-112.06,2208946,190852.93,1331,2648,0.55,11,0,0
1326,台化         ,20191004,0,0,32343,2794.44,158,13.65,2209344,190887.32,1281,919,0.55,0,0,0
1326,台化         ,20191007,-6,-0.52,32337,2803.62,202,17.51,2209113,191530.1,776,758,0.55,0,6,0
1326,台化         ,20191008,-6,-0.53,32331,2841.89,1607,141.26,2210690,194319.65,2835,1301,0.55,0,6,0
1326,台化         ,20191009,-18,-1.54,32313,2791.84,-1869,-161.48,2207999,190771.11,1571,3009,0.55,0,18,0
1326,台化         ,20191014,-194,-17.07,32119,2826.47,2151,189.29,2210142,194492.5,3054,717,0.55,0,194,0
1326,台化         ,20191015,0,0,32119,2832.9,1157,102.05,2211267,195033.75,1914,795,0.55,0,0,0
1326,台化         ,20191016,-29,-2.55,32090,2823.92,150,13.2,2211778,194636.46,3294,2887,0.55,0,29,0
1326,台化         ,20191017,9,0.77,32099,2821.5,1754,154.18,2214113,194620.53,3246,1510,0.55,9,0,0
1326,台化         ,20191018,197,17.38,32296,2845.28,1536,135.32,2215688,195202.11,2695,1529,0.55,197,0,0
1326,台化         ,20191021,-116,-10.22,32180,2838.28,1554,137.06,2217127,195550.6,1876,356,0.55,0,116,0
1326,台化         ,20191022,-124,-11.03,32056,2852.98,1328,118.19,2218701,197464.39,2681,1270,0.55,22,146,0
1326,台化         ,20191023,-29,-2.57,32027,2834.39,976,86.38,2220078,196476.9,2097,1053,0.55,0,29,0
1326,台化         ,20191024,170,15.2,32197,2878.41,940,84.04,2221514,198603.35,2824,1734,0.55,170,0,0
1326,台化         ,20191025,-8,-0.74,32189,2858.38,-249,-22.11,2221289,197250.46,1642,1966,0.55,0,8,0
1326,台化         ,20191028,143,12.71,32332,2874.31,992,88.19,2222342,197566.2,1759,959,0.55,218,75,0
1326,台化         ,20191029,-6,-0.53,32326,2867.32,1556,138.02,2223793,197250.44,2598,1141,0.55,0,6,0
1326,台化         ,20191030,7,0.62,32333,2880.87,1963,174.9,2225636,198304.17,3418,1582,0.55,10,3,0
1326,台化         ,20191031,-11,-0.97,32322,2863.73,911,80.71,2226453,197263.74,3384,2515,0.55,0,11,0
1326,台化         ,20191101,9,0.8,32331,2877.46,479,42.63,2226652,198172.03,1316,769,0.55,9,0,0
1326,台化         ,20191104,-5,-0.45,32326,2912.57,1783,160.65,2227849,200729.19,2847,1090,0.55,4,9,0
1326,台化         ,20191105,14,1.27,32340,2933.24,228,20.68,2228527,202127.4,2175,2062,0.55,87,73,0
1326,台化         ,20191106,105,9.44,32445,2916.81,362,32.54,2228805,200369.57,1506,1233,0.55,107,2,0
1326,台化         ,20191107,131,11.71,32576,2912.29,382,34.15,2229665,199332.05,1323,1005,0.56,163,32,0
1326,台化         ,20191108,126,11.18,32702,2900.67,-1027,-91.09,2228906,197703.96,977,2154,0.56,126,0,0
1326,台化         ,20191111,-59,-5.16,32643,2856.26,-454,-39.73,2228796,195019.65,1818,2431,0.56,9,68,0
1326,台化         ,20191112,-294,-25.78,32349,2837.01,-168,-14.73,2228775,195463.57,1206,1048,0.55,52,346,0
1326,台化         ,20191113,-241,-21.02,32108,2799.82,-1711,-149.2,2226771,194174.43,743,2138,0.55,0,241,0
1326,台化         ,20191114,23,2.01,32131,2811.46,-386,-33.78,2226485,194817.44,1017,1430,0.55,23,0,0
1326,台化         ,20191115,0,0,32131,2808.25,-927,-81.02,2225582,194515.87,1449,2328,0.55,0,0,0
1326,台化         ,20191118,90,7.87,32221,2816.12,-760,-66.42,2224811,194448.48,1287,2130,0.55,90,0,0
1326,台化         ,20191119,-30,-2.61,32191,2800.62,-896,-77.95,2223915,193480.61,1947,2808,0.55,0,30,0
1326,台化         ,20191120,38,3.29,32229,2787.81,-1068,-92.38,2222809,192272.98,1662,2638,0.55,38,0,0
1326,台化         ,20191121,106,9.16,32335,2800.21,-975,-84.44,2221491,192381.12,1151,2189,0.55,106,0,0
1326,台化         ,20191122,15,1.31,32350,2827.39,505,44.14,2221370,194147.74,1787,1318,0.55,28,13,0
1326,台化         ,20191125,4,0.35,32354,2840.68,600,52.68,2222243,195112.94,2037,1163,0.55,4,0,0
1326,台化         ,20191126,24,2.11,32378,2852.5,1720,151.53,2224020,195936.16,12148,10318,0.55,25,1,0
1326,台化         ,20191127,297,26.23,32675,2885.2,217,19.16,2224075,196385.82,817,1022,0.56,297,0,0
1326,台化         ,20191128,6,0.48,32681,2866.12,240,21.05,2224209,195063.13,1819,1586,0.56,6,0,0
1326,台化         ,20191129,5,0.44,32686,2853.49,-741,-64.69,2222815,194051.75,1222,2091,0.56,15,10,0
1326,台化         ,20191202,28,2.44,32714,2846.12,265,23.06,2223109,193410.48,1231,1197,0.56,28,0,0
1326,台化         ,20191203,11,0.96,32725,2847.08,375,32.63,2223444,193439.63,845,485,0.56,11,0,0
1326,台化         ,20191204,-172,-14.98,32553,2835.37,18,1.57,2223446,193662.15,1492,1318,0.56,8,180,0
1326,台化         ,20191205,17,1.47,32570,2820.56,-712,-61.66,2224199,192615.63,1217,1890,0.56,17,0,0
1326,台化         ,20191206,-26,-2.25,32544,2821.56,-202,-17.51,2223120,192744.5,641,735,0.56,5,31,0
1326,台化         ,20191209,-344,-29.76,32200,2785.3,128,11.07,2223248,192310.95,1095,617,0.55,15,359,0
1326,台化         ,20191210,10,0.87,32210,2792.61,-414,-35.89,2222800,192716.76,464,886,0.55,10,0,0
1326,台化         ,20191211,9,0.78,32219,2793.39,-2079,-180.25,2220744,192538.5,1238,3316,0.55,9,0,0
1326,台化         ,20191212,-72,-6.31,32147,2816.08,1701,149.01,2222114,194657.19,3480,1706,0.55,0,72,0
1326,台化         ,20191213,-9,-0.78,32138,2792.79,667,57.96,2222225,193111.35,2774,2102,0.55,0,9,0
1326,台化         ,20191216,0,0,32138,2799.22,-732,-63.76,2220961,193445.7,2044,2741,0.55,0,0,0
1326,台化         ,20191217,107,9.41,32245,2844.01,538,47.45,2221468,195933.48,3061,2761,0.55,121,14,0
1326,台化         ,20191218,169,14.92,32414,2862.16,-763,-67.37,2220957,196110.5,3612,4602,0.55,169,0,0
1326,台化         ,20191219,114,10.03,32528,2862.46,-1202,-105.78,2219979,195358.15,1374,2856,0.55,118,4,0
1326,台化         ,20191220,729,64.81,33257,2956.55,1031,91.66,2221240,197468.24,6070,5845,0.57,1010,281,0.01
1326,台化         ,20191223,837,74.83,34094,3048,718,64.19,2223738,198802.18,1759,1882,0.58,839,2,0.01
1326,台化         ,20191224,775,68.98,34869,3103.34,162,14.42,2224750,198002.75,485,1095,0.59,796,21,0.01
1326,台化         ,20191225,124,11.02,34993,3110.88,-93,-8.27,2224208,197732.09,211,764,0.6,124,0,0
1326,台化         ,20191226,2,0.18,34995,3104.06,160,14.19,2224788,197338.7,655,213,0.6,2,0,0
1326,台化         ,20191227,0,0,34995,3118.05,1352,120.46,2226225,198356.65,1786,450,0.6,0,0,0
1326,台化         ,20191230,31,2.73,35026,3082.29,164,14.43,2226431,195925.93,1938,1771,0.6,31,0,0
1326,台化         ,20191231,25,2.19,35471,3103.71,-407,-35.61,2226186,194791.28,805,1271,0.61,25,0,0
1326,台化         ,20200102,-588,-51.57,34883,3059.24,-870,-76.3,2223492,195000.25,945,1168,0.6,0,588,0.01
1326,台化         ,20200103,-258,-22.85,34625,3067.78,-389,-34.47,2223924,197039.67,1335,1422,0.59,17,275,0
1326,台化         ,20200106,18,1.59,34643,3065.91,-340,-30.09,2223566,196785.59,987,1306,0.59,18,0,0
1326,台化         ,20200107,74,6.47,34717,3034.27,-3269,-285.71,2221551,194163.56,662,4073,0.59,74,0,0
1326,台化         ,20200108,84,7.27,34801,3013.77,-2664,-230.7,2219093,192173.45,667,3428,0.59,84,0,0
1326,台化         ,20200109,405,35.32,35206,3069.96,-62,-5.41,2219142,193509.18,676,1147,0.6,467,62,0
1326,台化         ,20200110,198,17.25,35404,3083.69,-790,-68.81,2218435,193225.69,814,1744,0.6,508,310,0.01
1326,台化         ,20200113,314,27.48,35718,3125.33,-412,-36.05,2218708,194136.95,1213,1679,0.61,361,47,0
1326,台化         ,20200114,279,24.52,35997,3164.14,-812,-71.37,2218818,195034.1,1306,2014,0.61,386,107,0
1326,台化         ,20200115,-81,-7.03,35916,3135.47,-1584,-138.28,2219324,193746.99,1400,2214,0.61,0,81,0
1326,台化         ,20200116,-136,-11.86,35780,3120.02,-781,-68.1,2218463,193449.97,496,1153,0.61,14,150,0
1326,台化         ,20200117,-385,-33.92,35395,3114.76,-800,-70.4,2217494,195139.47,856,1301,0.6,5,390,0
1326,台化         ,20200120,-273,-24.08,35122,3097.76,-48,-4.23,2217560,195588.79,1364,1178,0.6,0,273,0
1326,台化         ,20200130,205,17.36,35327,2992.2,-4397,-372.43,2213018,187442.62,3333,8639,0.6,557,352,0.01
1326,台化         ,20200131,-91,-7.73,35236,2991.54,-2268,-192.55,2210538,187674.68,2313,4740,0.6,40,131,0
1326,台化         ,20200203,86,7.21,35322,2959.98,-208,-17.43,2210128,185208.73,2586,3260,0.6,86,0,0
1326,台化         ,20200204,-222,-18.54,35100,2930.85,-2213,-184.79,2207700,184342.95,1968,4000,0.6,0,222,0
1326,台化         ,20200205,-313,-25.82,34787,2869.93,-1707,-140.83,2205993,181994.42,2570,3800,0.59,11,324,0
1326,台化         ,20200206,233,19.68,35020,2952.19,-95,-8.01,2205906,185957.88,4411,4714,0.6,233,0,0
1326,台化         ,20200207,6,0.5,35026,2942.18,-806,-67.7,2205067,185225.63,1026,1857,0.6,6,0,0
1326,台化         ,20200210,-80,-6.71,34946,2931.97,-437,-36.66,2202795,184814.5,851,1185,0.6,0,80,0
1326,台化         ,20200211,45,3.78,34991,2935.74,-492,-41.28,2202323,184774.9,574,1126,0.6,51,6,0
1326,台化         ,20200212,31,2.63,35022,2973.37,-433,-36.76,2201857,186937.66,1110,1686,0.6,31,0,0
1326,台化         ,20200213,47,4.01,35069,2994.89,-602,-51.41,2201420,188001.27,1559,2059,0.6,47,0,0
1326,台化         ,20200214,31,2.64,35100,2990.52,-412,-35.1,2201082,187532.19,1048,1465,0.6,31,0,0
1326,台化         ,20200217,1,0.08,35101,2973.05,-741,-62.76,2200346,186369.31,480,1169,0.6,1,0,0
1326,台化         ,20200218,59,5,35160,2978.05,-1720,-145.68,2198776,186236.33,1149,2852,0.6,59,0,0
1326,台化         ,20200219,25,2.13,35185,3004.8,404,34.5,2199183,187810.23,1989,1636,0.6,32,7,0
1326,台化         ,20200220,5,0.42,35190,2970.04,-2188,-184.67,2196405,185376.58,756,2920,0.6,5,0,0
1326,台化         ,20200221,41,3.46,35231,2973.5,-963,-81.28,2195136,185269.48,661,1656,0.6,41,0,0
1326,台化         ,20200224,201,16.7,35432,2944.4,-3603,-299.41,2190743,182050.74,1099,4950,0.6,201,0,0
1326,台化         ,20200225,-357,-29.49,35075,2897.2,-1578,-130.34,2189137,180822.72,1085,2311,0.6,37,394,0
1326,台化         ,20200226,78,6.33,35153,2854.42,-4277,-347.29,2185272,177444.09,1852,6438,0.6,148,70,0
1326,台化         ,20200227,179,14.71,35332,2904.29,-716,-58.86,2184201,179541.32,3180,4399,0.6,179,0,0
1326,台化         ,20200302,95,7.7,35427,2869.59,-1886,-152.77,2182264,176763.38,3283,5684,0.6,97,2,0
1326,台化         ,20200303,34,2.75,35461,2865.25,-2964,-239.49,2178711,176039.85,1429,4361,0.61,40,6,0
1326,台化         ,20200304,68,5.56,35529,2906.27,1514,123.85,2179314,178267.89,3624,1995,0.61,68,0,0
1326,台化         ,20200305,0,0,35529,2913.38,-688,-56.42,2178418,178630.28,2673,3481,0.61,0,0,0
1326,台化         ,20200306,-194,-15.62,35335,2844.47,-3853,-310.17,2174569,175052.8,1043,4693,0.6,5,199,0
1326,台化         ,20200309,307,23.85,35642,2769.38,-5675,-440.95,2169266,168551.97,1868,8579,0.61,475,168,0.01
1326,台化         ,20200310,30,2.33,35672,2768.15,743,57.66,2170194,168407.05,3737,3513,0.61,30,0,0
1326,台化         ,20200311,6,0.43,35678,2765.05,-1592,-123.38,2168380,168049.45,3358,4580,0.61,6,0,0
1326,台化         ,20200312,94,7.06,35772,2686.48,-4998,-375.35,2163823,162503.11,2366,8510,0.61,94,0,0
1326,台化         ,20200313,-91,-6.54,35681,2579.74,-6806,-492.07,2157405,155980.38,5492,13220,0.61,115,206,0
1326,台化         ,20200316,100,6.92,35781,2476.05,-6634,-459.07,2152079,148923.87,2546,9303,0.61,116,16,0
1326,台化         ,20200317,179,11.85,35960,2380.55,-4489,-297.17,2147905,142191.31,5870,11177,0.61,253,74,0
1326,台化         ,20200318,285,17.58,36245,2236.32,-4270,-263.46,2143948,132281.59,5221,10083,0.62,335,50,0
1326,台化         ,20200319,85,5.03,36330,2154.37,-2694,-159.75,2140636,126939.71,6633,10056,0.62,102,17,0
1326,台化         ,20200320,255,16.57,36585,2381.68,-3957,-257.6,2136136,139062.45,6689,10538,0.62,280,25,0
1326,台化         ,20200323,-4,-0.25,36581,2268.02,-1290,-79.98,2134707,132351.83,4866,6613,0.62,21,25,0
1326,台化         ,20200324,-2,-0.13,36579,2384.95,1112,72.5,2136116,139274.76,5435,3901,0.62,0,2,0
1326,台化         ,20200325,-8,-0.55,36571,2505.11,488,33.43,2136423,146344.98,3981,3215,0.62,0,8,0
1326,台化         ,20200326,13,0.9,36584,2506,183,12.54,2136652,146360.66,3045,2801,0.62,30,17,0
1326,台化         ,20200327,4,0.27,36588,2487.98,-861,-58.55,2135581,145219.51,1992,2614,0.62,5,1,0
1326,台化         ,20200330,0,0,36588,2477.01,-337,-22.81,2134987,144538.62,3699,4034,0.62,0,0,0
1326,台化         ,20200331,90,6.03,52374,3509.06,-2522,-168.97,2145486,143747.56,4345,6844,0.89,92,2,0
1326,台化         ,20200401,5,0.33,52379,3467.49,-896,-59.32,2144740,141981.79,3027,3937,0.89,5,0,0
1326,台化         ,20200406,18,1.22,52397,3563,444,30.19,2142448,145686.46,4010,3596,0.89,18,0,0
1326,台化         ,20200407,36,2.52,52433,3665.07,-141,-9.86,2141430,149685.96,2996,3156,0.89,36,0,0
1326,台化         ,20200408,-505,-35.8,51928,3681.7,381,27.01,2141677,151844.9,3335,2263,0.89,8,513,0
1326,台化         ,20200409,2,0.14,51930,3666.26,-2184,-154.19,2139628,151057.74,1038,3214,0.89,2,0,0
1326,台化         ,20200410,-65,-4.62,51865,3682.42,-1308,-92.87,2137649,151773.08,1357,2588,0.88,10,75,0
1326,台化         ,20200413,-11,-0.8,51854,3629.78,-1403,-98.21,2136399,149547.93,491,1760,0.88,0,11,0
1326,台化         ,20200414,29,2.07,51883,3704.45,2632,187.92,2138570,152693.9,5278,2650,0.89,29,0,0
1326,台化         ,20200415,0,0,51883,3735.58,-237,-17.06,2138620,153980.64,2952,3043,0.89,0,0,0
1326,台化         ,20200416,-3,-0.21,51880,3673.1,-4006,-283.62,2134819,151145.19,2583,6514,0.89,2,5,0
1326,台化         ,20200417,0,0,51880,3688.67,397,28.23,2135317,151821.04,3471,3110,0.89,0,0,0
1326,台化         ,20200420,6,0.42,51886,3647.59,-2576,-181.09,2132968,149947.65,1380,3900,0.89,6,0,0
1326,台化         ,20200421,-4,-0.28,51882,3574.67,-3712,-255.76,2129308,146709.32,1524,4955,0.89,0,4,0
1326,台化         ,20200422,46,3.14,51928,3546.68,-1376,-93.98,2128367,145367.47,1709,2995,0.89,49,3,0
1326,台化         ,20200423,14,0.96,51942,3568.42,-2049,-140.77,2128509,146228.57,3017,5017,0.89,18,4,0
1326,台化         ,20200424,33,2.25,51975,3549.89,-1705,-116.45,2126354,145229.98,1633,3359,0.89,38,5,0
1326,台化         ,20200427,49,3.44,52024,3652.08,3265,229.2,2129706,149505.36,5761,2466,0.89,49,0,0
1326,台化         ,20200428,321,22.6,52345,3685.09,317,22.32,2129862,149942.28,1437,1386,0.89,321,0,0
1326,台化         ,20200429,23,1.65,52368,3760.02,2622,188.26,2132634,153123.12,4761,1915,0.89,23,0,0
1326,台化         ,20200430,28,2.13,52396,3976.86,2590,196.58,2135390,162076.1,5515,2838,0.89,28,0,0
1326,台化         ,20200504,186,13.56,52582,3833.23,-8310,-605.8,2127157,155069.75,896,9353,0.9,186,0,0
1326,台化         ,20200505,-113,-8.26,52469,3819.74,-2926,-213.01,2124477,154661.93,439,3206,0.9,5,118,0
1326,台化         ,20200506,60,4.36,52529,3813.61,-2710,-196.75,2122196,154071.43,1577,4174,0.9,60,0,0
1326,台化         ,20200507,31,2.26,52560,3826.37,-800,-58.24,2121785,154465.95,2720,3517,0.9,31,0,0
1326,台化         ,20200508,4,0.29,52564,3873.97,-1355,-99.86,2120715,156296.7,1530,2840,0.9,4,0,0
1326,台化         ,20200511,24,1.79,52588,3928.32,-1534,-114.59,2121766,158495.92,1665,3206,0.9,24,0,0
1326,台化         ,20200512,0,0,52588,3859.96,-5185,-380.58,2117128,155397.2,1025,6169,0.9,0,0,0
1326,台化         ,20200513,29,2.14,52617,3888.4,-139,-10.27,2118125,156529.44,2093,2167,0.9,29,0,0
1326,台化         ,20200514,22,1.6,52639,3821.59,-3999,-290.33,2114179,153489.4,508,4532,0.9,44,22,0
1326,台化         ,20200515,0,0,52639,3805.8,-717,-51.84,2113423,152800.48,1720,2420,0.9,0,0,0
1326,台化         ,20200518,0,0,52639,3795.27,-1179,-85.01,2112303,152297.05,1959,3257,0.9,0,0,0
1326,台化         ,20200519,26,1.9,52665,3855.08,1331,97.43,2113414,154701.9,4160,2939,0.9,26,0,0
1326,台化         ,20200520,-63,-4.61,52602,3850.47,-1116,-81.69,2112106,154606.16,1825,3085,0.9,9,72,0
1326,台化         ,20200521,0,0,52602,3876.77,-493,-36.33,2111680,155630.82,2461,2893,0.9,0,0,0
1326,台化         ,20200522,3,0.22,52605,3798.08,-5743,-414.64,2106363,152079.41,409,6223,0.9,3,0,0
1326,台化         ,20200525,15,1.11,52620,3783.38,-2761,-198.52,2103964,151275.01,1482,4254,0.9,15,0,0
1326,台化         ,20200526,-14,-1.02,52606,3824.46,1968,143.07,2105893,153098.42,4211,2228,0.9,0,14,0
1326,台化         ,20200527,10,0.73,52616,3819.92,-572,-41.53,2105094,152829.82,1703,2280,0.9,10,0,0
1326,台化         ,20200528,0,0,52616,3788.35,-2070,-149.04,2103435,151447.32,1639,3656,0.9,0,0,0
1326,台化         ,20200529,0,0,52616,3788.35,-1056,-76.03,2102278,151364.02,9003,10038,0.9,0,0,0
1326,台化         ,20200601,-9,-0.65,52607,3814.01,417,30.23,2102708,152446.33,3163,2763,0.9,0,9,0
1326,台化         ,20200602,0,0,52607,3850.83,46,3.37,2102769,153922.69,1502,1451,0.9,0,0,0
1326,台化         ,20200603,-22,-1.65,52585,3938.62,4019,301.02,2106810,157800.07,5798,2328,0.9,0,22,0
1326,台化         ,20200604,0,0,52585,3949.13,71,5.33,2107008,158236.3,2489,2336,0.9,0,0,0
1326,台化         ,20200605,0,0,52585,3975.43,1130,85.43,2108023,159366.54,3556,2313,0.9,0,0,0
1326,台化         ,20200608,-39,-3,52546,4035.53,1203,92.39,2111167,162137.63,4195,2951,0.9,0,39,0
1326,台化         ,20200609,16,1.23,52562,4047.27,-502,-38.65,2110136,162480.47,2198,2728,0.9,21,5,0
1326,台化         ,20200610,-16,-1.23,52546,4051.3,348,26.83,2108485,162564.19,4045,3644,0.9,0,16,0
1326,台化         ,20200611,-14,-1.05,52532,3955.66,-3145,-236.82,2104551,158472.69,2074,5147,0.9,0,14,0
1326,台化         ,20200612,-20,-1.48,52512,3896.39,-1877,-139.27,2100876,155885,2356,4163,0.9,0,20,0
1326,台化         ,20200615,-3,-0.22,52509,3843.66,-4156,-304.22,2095691,153404.58,2057,6012,0.9,0,3,0
1326,台化         ,20200616,-108,-8.01,52401,3872.43,-1724,-127.4,2093157,154684.3,2784,4434,0.89,0,108,0
1326,台化         ,20200617,-224,-16.55,52177,3855.88,-1748,-129.18,2090387,154479.6,2212,3475,0.89,0,224,0
1326,台化         ,20200618,-125,-9.23,52052,3841.44,-2751,-203.02,2087324,154044.51,1377,3939,0.89,0,125,0
1326,台化         ,20200619,-3682,-269.15,48370,3535.85,-5942,-434.36,2080356,152074.02,6611,8850,0.83,10,3692,0.03
1326,台化         ,20200622,-3150,-233.41,45220,3350.8,-1735,-128.56,2078330,154004.25,4135,2735,0.77,200,3350,0.03
1326,台化         ,20200623,-3215,-241.13,42005,3150.38,448,33.6,2078467,155885.03,6162,2490,0.72,73,3288,0.03
1326,台化         ,20200624,-3156,-238.28,38849,2933.1,-1902,-143.6,2076496,156775.45,5300,4006,0.66,140,3296,0.03
1326,台化         ,20200629,-3283,-246.22,35566,2667.45,-2814,-211.05,2069676,155225.7,4795,6324,0.61,4,3287,0.03
1326,台化         ,20200630,16,1.21,38284,2898.1,2962,224.22,2067224,156488.86,4620,4062,0.65,16,0,0
1326,台化         ,20200701,-16,-1.16,38268,2774.43,-1336,-96.86,2071851,150209.2,5613,2387,0.65,0,16,0
1326,台化         ,20200702,-11,-0.8,38257,2785.11,-1098,-79.93,2070755,150750.96,990,2052,0.65,0,11,0
1326,台化         ,20200703,-33,-2.42,38224,2805.64,625,45.88,2071382,152039.44,1687,1033,0.65,0,33,0
1326,台化         ,20200706,-41,-3.01,38183,2798.81,1380,101.15,2079139,152400.89,3021,1083,0.65,0,41,0
1326,台化         ,20200707,-25,-1.82,38158,2774.09,-156,-11.34,2079170,151155.66,2427,2571,0.65,0,25,0
1326,台化         ,20200708,-21,-1.52,38137,2757.31,-1165,-84.23,2077714,150218.72,1643,2945,0.65,0,21,0
1326,台化         ,20200709,-58,-4.18,38079,2741.69,-1854,-133.49,2074931,149395.03,934,2725,0.65,0,58,0
1326,台化         ,20200710,-35,-2.52,38044,2701.12,-3957,-280.95,2071001,147041.07,952,4838,0.65,0,35,0
1326,台化         ,20200713,-12,-0.85,38032,2700.27,-885,-62.84,2069688,146947.85,2109,2978,0.65,0,12,0
1326,台化         ,20200714,-54,-3.83,37978,2696.44,-218,-15.48,2069607,146942.1,1775,1912,0.65,0,54,0
1326,台化         ,20200715,-58,-4.11,37920,2707.49,-767,-54.76,2070852,147858.83,2264,3063,0.65,0,58,0
1326,台化         ,20200716,6,0.43,37926,2715.5,-281,-20.12,2070970,148281.45,2150,2357,0.65,25,19,0
1326,台化         ,20200717,-52,-3.69,37874,2689.05,-320,-22.72,2071542,147079.48,1685,1985,0.65,20,72,0
1326,台化         ,20200720,-45,-3.2,37829,2685.86,-600,-42.6,2071339,147065.07,1107,1667,0.65,0,45,0
1326,台化         ,20200721,-82,-5.85,37747,2695.14,2325,166.01,2074021,148085.1,3396,982,0.64,0,82,0
1326,台化         ,20200722,-38,-2.71,37709,2692.42,700,49.98,2074429,148114.23,1906,1136,0.64,1,39,0
1326,台化         ,20200723,-81,-5.72,37628,2656.54,-1315,-92.84,2073164,146365.38,1174,2343,0.64,0,81,0
1326,台化         ,20200724,-46,-3.21,37582,2623.22,-2060,-143.79,2071356,144580.65,1014,2860,0.64,0,46,0
1326,台化         ,20200727,-14,-0.92,37568,2569.65,-1373,-93.91,2070277,141606.95,1111,2424,0.64,24,38,0
1326,台化         ,20200728,-40,-2.7,37528,2533.14,-1063,-71.75,2069392,139683.96,2399,3397,0.64,0,40,0
1326,台化         ,20200729,-10,-0.67,37518,2524.96,-548,-36.88,2069623,139285.63,1031,972,0.64,1,11,0
1326,台化         ,20200730,-23,-1.56,37495,2542.16,-225,-15.26,2069456,140309.12,1363,1536,0.64,1,24,0
1326,台化         ,20200731,-500,-33.7,36995,2493.46,-1823,-122.87,2067709,139363.59,1517,2835,0.63,2,502,0
1326,台化         ,20200803,-169,-11.26,36826,2452.61,-3716,-247.49,2064226,137477.45,1589,5136,0.63,19,188,0
1326,台化         ,20200804,54,3.62,36880,2470.96,-672,-45.02,2063685,138266.9,1090,1816,0.63,54,0,0
1326,台化         ,20200805,8,0.58,36888,2515.76,-286,-19.51,2063382,140722.65,1140,1404,0.63,14,6,0
1326,台化         ,20200806,9,0.62,36897,2531.13,826,56.66,2064104,141597.53,1737,951,0.63,15,6,0
1326,台化         ,20200807,0,0,36897,2549.58,478,33.03,2064660,142668.01,1791,1351,0.63,0,0,0
1326,台化         ,20200810,14,0.99,36911,2609.61,1238,87.53,2065745,146048.17,1916,725,0.63,14,0,0
1326,台化         ,20200811,20,1.42,36931,2622.1,1899,134.83,2067644,146802.72,3238,1400,0.63,21,1,0
1326,台化         ,20200812,36,2.55,36967,2613.57,1284,90.78,2068782,146262.89,2448,968,0.63,36,0,0
1326,台化         ,20200813,61,4.36,37028,2643.8,2390,170.65,2070895,147861.9,3044,711,0.63,61,0,0
1326,台化         ,20200814,11,0.79,37039,2648.29,1065,76.15,2071681,148125.19,1552,524,0.63,11,0,0
1326,台化         ,20200817,-17,-1.23,37022,2676.69,2230,161.23,2073555,149918.03,2616,465,0.63,2,19,0
1326,台化         ,20200818,4,0.29,37026,2665.87,758,54.58,2074679,149376.89,1430,722,0.63,4,0,0
1326,台化         ,20200819,-11,-0.82,37015,2635.47,947,67.43,2076238,147828.15,1480,610,0.63,6,17,0
1326,台化         ,20200820,55,3.81,37070,2568.95,-1761,-122.04,2074600,143769.78,1451,3230,0.63,55,0,0
1326,台化         ,20200821,52,3.64,37122,2598.54,2051,143.57,2077393,145417.51,2463,450,0.63,52,0,0
1326,台化         ,20200824,-55,-3.86,37067,2576.16,-108,-7.51,2077081,144357.13,1022,1076,0.63,10,65,0
1326,台化         ,20200825,0,0,37067,2587.28,952,66.45,2079268,145132.91,2490,1554,0.63,0,0,0
1326,台化         ,20200826,29,2,37096,2604.14,-56,-3.93,2079153,145956.54,2045,2121,0.63,29,0,0
1326,台化         ,20200827,0,0,37096,2578.17,-995,-69.15,2077974,144419.19,578,1557,0.63,0,0,0
1326,台化         ,20200828,25,1.75,37121,2594.76,221,15.45,2078033,145254.51,1747,1542,0.63,26,1,0
1326,台化         ,20200831,-83,-5.66,37038,2511.18,-2998,-203.26,2075361,140709.48,3905,6810,0.63,8,91,0
1326,台化         ,20200901,8,0.54,37046,2519.13,-2451,-166.67,2071185,140840.58,3236,5657,0.63,19,11,0
1326,台化         ,20200902,-49,-3.31,36997,2501,-1962,-132.63,2069074,139869.4,974,2834,0.63,5,54,0
1326,台化         ,20200903,-7,-0.45,36990,2522.72,1428,97.39,2071575,141281.42,3026,1704,0.63,0,7,0
1326,台化         ,20200904,2,0.14,36992,2504.36,-788,-53.35,2070789,140192.42,1332,2126,0.63,2,0,0
1326,台化         ,20200907,74,5.11,37066,2557.55,1891,130.48,2072534,143004.85,4291,2537,0.63,74,0,0
1326,台化         ,20200908,1030,72.69,38096,2689.58,5636,397.9,2078060,146711.04,6624,1989,0.65,1030,0,0.01
1326,台化         ,20200909,17,1.19,38113,2660.29,-1667,-116.36,2075566,144874.51,1251,2846,0.65,17,0,0
1326,台化         ,20200910,0,0,38113,2637.42,-65,-4.5,2075286,143609.79,1610,1640,0.65,0,0,0
1326,台化         ,20200911,17,1.17,38130,2623.34,-1605,-110.42,2073090,142628.59,1427,3008,0.65,17,0,0
1326,台化         ,20200914,-122,-8.33,38008,2595.95,-3381,-230.92,2070089,141387.08,2526,5798,0.65,0,122,0
1326,台化         ,20200915,-14,-0.92,37994,2583.59,-280,-19.04,2072395,140922.86,1957,2219,0.65,0,14,0
1326,台化         ,20200916,6,0.41,38000,2595.4,-59,-4.03,2072245,141534.33,1915,1823,0.65,93,87,0
1326,台化         ,20200917,-19,-1.32,37981,2590.3,-1200,-81.84,2071450,141272.89,1138,2246,0.65,4,23,0
1326,台化         ,20200918,165,11.5,38146,2658.78,7440,518.57,2079096,144912.99,18321,11121,0.65,261,96,0
1326,台化         ,20200921,-1,-0.04,38145,2677.78,1067,74.9,2079918,146010.24,4807,3512,0.65,4,5,0
1326,台化         ,20200922,-19,-1.27,38126,2604.01,-4937,-337.2,2075696,141770.04,1051,5819,0.65,1,20,0
1326,台化         ,20200923,19,1.33,38145,2593.86,-2146,-145.93,2073265,140982.02,796,2436,0.65,33,14,0
1326,台化         ,20200924,0,0,38145,2548.09,-8206,-548.16,2065239,137957.97,705,8857,0.65,0,0,0
1326,台化         ,20200925,57,3.85,38202,2578.64,-228,-15.39,2065073,139392.43,1589,1872,0.65,57,0,0
1326,台化         ,20200928,0,0,38202,2578.64,-259,-17.48,2065716,139435.83,1761,1998,0.65,0,0,0
1326,台化         ,20200929,0,0,38202,2590.1,778,52.75,2066451,140105.38,2876,2155,0.65,0,0,0
1326,台化         ,20200930,0,0,32351,2190.16,-44,-2.98,2059667,139439.46,1953,1951,0.55,0,0,0
1326,台化         ,20201005,0,0,32351,2216.04,812,55.62,2060431,141139.52,1570,777,0.55,0,0,0
1326,台化         ,20201006,8,0.56,32359,2245.71,2057,142.76,2063476,143205.23,2519,468,0.55,8,0,0
1326,台化         ,20201007,-4,-0.28,32355,2226.02,-113,-7.77,2063444,141964.95,1271,1416,0.55,0,4,0
1326,台化         ,20201008,-5,-0.35,32350,2238.62,-100,-6.92,2063384,142786.17,1037,1134,0.55,0,5,0
1326,台化         ,20201012,-282,-19.74,32068,2244.76,1272,89.04,2064551,144518.57,3587,2047,0.55,0,282,0
1326,台化         ,20201013,-526,-36.45,31542,2185.86,-1324,-91.75,2063537,143003.11,1235,2000,0.54,0,526,0
1326,台化         ,20201014,0,0,31542,2170.09,-913,-62.81,2062751,141917.27,3274,4030,0.54,0,0,0
1326,台化         ,20201015,0,0,31542,2189.01,-1123,-77.94,2061915,143096.9,2271,3358,0.54,0,0,0
1326,台化         ,20201016,9,0.62,31551,2177.02,-629,-43.4,2061368,142234.39,1754,2378,0.54,16,7,0
1326,台化         ,20201019,0,0,31551,2177.02,-1069,-73.76,2060278,142159.18,1143,2233,0.54,0,0,0
1326,台化         ,20201020,-114,-7.87,31437,2169.15,-530,-36.57,2059748,142122.61,2223,2662,0.54,0,114,0
1326,台化         ,20201021,122,8.38,31559,2168.1,-735,-50.49,2059436,141483.25,1412,1846,0.54,128,6,0
1326,台化         ,20201022,9,0.62,31568,2187.66,682,47.26,2060449,142789.12,5547,4876,0.54,14,5,0
1326,台化         ,20201023,234,16.22,31802,2203.88,-484,-33.54,2060018,142759.25,929,1647,0.54,234,0,0
1326,台化         ,20201026,0,0,31802,2235.68,3348,235.36,2065065,145174.07,4976,882,0.54,0,0,0
1326,台化         ,20201027,0,0,31802,2235.68,344,24.18,2065302,145190.73,2788,2494,0.54,0,0,0
1326,台化         ,20201028,-10,-0.7,31792,2225.44,-194,-13.58,2065524,144586.68,1203,979,0.54,0,10,0
1326,台化         ,20201029,-128,-8.79,31664,2175.32,-2168,-148.94,2063717,141777.36,891,2908,0.54,7,135,0
1326,台化         ,20201030,0,0,31664,2178.48,-2214,-152.32,2061584,141836.98,2060,4127,0.54,0,0,0
1326,台化         ,20201102,12,0.84,31676,2210.98,544,37.97,2062516,143963.62,1083,552,0.54,12,0,0
1326,台化         ,20201103,0,0,31676,2229.99,2959,208.31,2065693,145424.79,3772,836,0.54,0,0,0
1326,台化         ,20201104,21,1.49,31697,2250.49,1750,124.25,2067783,146812.59,2950,1269,0.54,21,0,0
1326,台化         ,20201105,5,0.36,31702,2260.35,1297,92.48,2068989,147518.92,2584,1279,0.54,5,0,0
1326,台化         ,20201106,-1,-0.07,31701,2257.11,1701,121.11,2070258,147402.37,1849,208,0.54,0,1,0
1326,台化         ,20201109,-5,-0.36,31696,2278.94,2503,179.97,2072697,149026.91,2914,1253,0.54,0,5,0
1326,台化         ,20201110,933,69.23,32629,2421.07,9650,716.03,2082301,154506.73,8209,833,0.56,933,0,0.01
1326,台化         ,20201111,2395,186.81,35024,2731.87,9839,767.44,2092140,163186.92,8384,2007,0.6,2420,25,0.02
1326,台化         ,20201112,1522,117.04,36546,2810.39,2702,207.78,2092874,160942.01,4186,3086,0.62,1588,66,0.01
1326,台化         ,20201113,333,25.61,36879,2836,2111,162.34,2094986,161104.42,3942,2025,0.63,333,0,0
1326,台化         ,20201116,1051,81.77,37930,2950.95,4671,363.4,2099459,163337.91,7274,3584,0.65,1051,0,0.01
1326,台化         ,20201117,802,62.55,38732,3021.1,3872,302.02,2103157,164046.25,5140,1620,0.66,880,78,0.01
1326,台化         ,20201118,1111,88.21,39843,3163.53,8299,658.94,2111457,167649.69,9381,2021,0.68,1117,6,0.01
1326,台化         ,20201119,458,36.55,40301,3216.02,935,74.61,2112301,168561.62,3739,3235,0.69,483,25,0
1326,台化         ,20201120,-125,-9.98,40176,3206.04,2026,161.67,2114328,168723.37,4324,2214,0.69,26,151,0
1326,台化         ,20201123,-278,-22.24,39898,3191.84,1812,144.96,2116073,169285.84,4706,2006,0.68,24,302,0
1326,台化         ,20201124,0,0,39898,3147.95,1251,98.7,2117284,167053.71,2728,1291,0.68,6,6,0
1326,台化         ,20201125,2,0.16,39900,3164.07,-337,-26.72,2116943,167873.58,1999,2297,0.68,2,0,0
1326,台化         ,20201126,28,2.23,39928,3182.26,-233,-18.57,2116700,168700.99,2531,2825,0.68,28,0,0
1326,台化         ,20201127,51,4.03,39979,3158.34,-1913,-151.13,2114032,167008.53,2747,4676,0.68,52,1,0
1326,台化         ,20201130,-134,-10.32,39845,3068.07,-3769,-290.21,2108331,162341.49,12212,16051,0.68,6,140,0
1326,台化         ,20201201,-57,-4.5,39788,3139.27,-225,-17.75,2107958,166317.89,2793,2877,0.68,75,132,0
1326,台化         ,20201202,-21,-1.66,39767,3137.62,-2189,-172.71,2105713,166140.76,3023,5237,0.68,1,22,0
1326,台化         ,20201203,28,2.23,39795,3167.68,-510,-40.6,2104707,167534.68,2277,2900,0.68,105,77,0
1326,台化         ,20201204,288,23.07,40083,3210.65,1396,111.82,2106285,168713.43,3665,2561,0.68,300,12,0
1326,台化         ,20201207,29,2.31,40112,3196.93,-2085,-166.17,2104070,167694.38,1591,3459,0.68,29,0,0
1326,台化         ,20201208,-2921,-230.76,37191,2938.09,-2621,-207.06,2101538,166021.5,1047,651,0.63,80,3001,0.03
1326,台化         ,20201209,-1070,-84.85,36121,2864.4,-559,-44.33,2101010,166610.09,2075,1534,0.62,18,1088,0.01
1326,台化         ,20201210,-1603,-127.12,34518,2737.28,-252,-19.98,2100918,166602.8,3311,1717,0.59,13,1616,0.01
1326,台化         ,20201211,-744,-58.79,33774,2668.15,93,7.35,2101094,165986.43,2475,1556,0.58,5,749,0.01
1326,台化         ,20201214,5,0.37,33779,2655.03,95,7.47,2100936,165133.57,2003,1835,0.58,5,0,0
1326,台化         ,20201215,15,1.2,33794,2646.07,-1103,-86.36,2099751,164410.5,1721,2739,0.58,15,0,0
1326,台化         ,20201216,134,10.69,33928,2707.45,2797,223.2,2102635,167790.27,3952,1182,0.58,134,0,0
1326,台化         ,20201217,211,16.7,34139,2707.22,-1681,-133.3,2101154,166621.51,1632,3367,0.58,219,8,0
1326,台化         ,20201218,-50,-3.94,34089,2669.17,-541,-42.36,2100426,164463.36,4310,4945,0.58,294,344,0.01
1326,台化         ,20201221,88,7.13,34177,2768.34,5421,439.1,2105857,170574.42,5588,801,0.58,98,10,0
1326,台化         ,20201222,21,1.67,34198,2725.58,-1207,-96.2,2104912,167761.49,1332,2297,0.58,24,3,0
1326,台化         ,20201223,-3,-0.24,34195,2704.82,-1121,-88.67,2103941,166421.73,588,1546,0.58,0,3,0
1326,台化         ,20201224,18,1.39,34213,2706.25,684,54.1,2104628,166476.07,1243,574,0.58,18,0,0
1326,台化         ,20201225,55,4.38,34268,2727.73,827,65.83,2105535,167600.59,1110,258,0.58,55,0,0
1326,台化         ,20201228,125,10.1,34393,2778.95,1651,133.4,2107637,170297.07,2035,590,0.59,135,10,0
1326,台化         ,20201229,-9,-0.76,34384,2798.86,1055,85.88,2108757,171652.82,1840,711,0.59,8,17,0
1326,台化         ,20201230,-10,-0.85,34374,2904.6,4874,411.85,2113122,178558.81,6916,2541,0.59,0,10,0
1326,台化         ,20201231,7,0.59,33418,2830.5,128,10.84,2113216,178989.4,4186,3434,0.57,47,40,0
1326,台化         ,20210104,-497,-42.08,32921,2785.12,488,41.28,2113705,178819.44,3214,2251,0.56,5,502,0
1326,台化         ,20210105,-116,-9.67,32805,2732.66,-1614,-134.45,2112091,175937.18,1073,2343,0.56,17,133,0
1326,台化         ,20210106,61,5.08,32866,2737.74,-500,-41.65,2112418,175964.42,2448,2290,0.56,80,19,0
1326,台化         ,20210107,-13,-1.09,32853,2818.79,4691,402.49,2116421,181588.92,5174,1649,0.56,11,24,0
1326,台化         ,20210108,-446,-38.5,32407,2796.72,1408,121.51,2118193,182800.06,4937,2923,0.55,14,460,0
1326,台化         ,20210111,26,2.25,32433,2798.97,292,25.2,2118404,182818.27,2768,2362,0.55,27,1,0
1326,台化         ,20210112,19,1.62,32452,2774.65,765,65.41,2119677,181232.38,3011,1591,0.55,19,0,0
1326,台化         ,20210113,-10,-0.86,32442,2786.77,1852,159.09,2121547,182240.89,4304,2554,0.55,13,23,0
1326,台化         ,20210114,23,1.96,32465,2772.51,1143,97.61,2122765,181284.13,2394,1331,0.55,43,20,0
1326,台化         ,20210115,50,4.2,32515,2728.01,464,38.93,2123153,178132.54,2257,1867,0.55,50,0,0
1326,台化         ,20210118,24,1.94,32539,2671.45,-518,-42.53,2122773,174279.66,2083,2487,0.56,24,0,0
1326,台化         ,20210119,52,4.32,32591,2708.31,239,19.86,2123356,176450.88,1857,1739,0.56,52,0,0
1326,台化         ,20210120,1,0.05,32592,2639.95,-1251,-101.33,2122275,171904.28,5182,6495,0.56,6,5,0
1326,台化         ,20210121,-90,-7.28,32502,2629.41,-79,-6.39,2122776,171732.58,2610,2591,0.55,85,175,0
1326,台化         ,20210122,72,5.81,32574,2628.72,-2306,-186.09,2120533,171127.01,1634,4125,0.56,83,11,0
1326,台化         ,20210125,69,5.7,32643,2679.99,580,47.62,2120922,174127.7,1982,1589,0.56,84,15,0
1326,台化         ,20210126,23,1.85,32666,2629.61,-3070,-247.14,2117921,170492.64,2330,5355,0.56,23,0,0
1326,台化         ,20210127,6,0.48,32672,2617.03,-1418,-113.58,2116402,169523.8,2536,3923,0.56,6,0,0
1326,台化         ,20210128,8,0.64,32680,2598.06,-1845,-146.68,2114529,168105.06,2735,4560,0.56,8,0,0
1326,台化         ,20210129,2,0.15,32682,2529.59,-3571,-276.4,2110950,163387.53,3463,7055,0.56,2,0,0
1326,台化         ,20210201,5,0.39,32687,2552.85,220,17.18,2110830,164855.82,1664,1581,0.56,5,0,0
1326,台化         ,20210202,4,0.32,32691,2595.67,583,46.29,2111410,167645.95,2608,2061,0.56,4,0,0
1326,台化         ,20210203,55,4.45,32746,2649.15,990,80.09,2112416,170894.45,3637,2707,0.56,55,0,0
1326,台化         ,20210204,48,3.86,32794,2639.92,-407,-32.76,2112047,170019.78,1499,1876,0.56,50,2,0
1326,台化         ,20210205,2,0.13,32796,2620.4,-898,-71.75,2111236,168687.76,1801,2796,0.56,7,5,0
1326,台化         ,20210217,17,1.42,32813,2739.89,2140,178.69,2113439,176472.16,6865,4833,0.56,17,0,0
1326,台化         ,20210218,-7,-0.58,32806,2732.74,-1001,-83.38,2112437,175966,2280,3144,0.56,34,41,0
1326,台化         ,20210219,46,3.82,32852,2726.72,-2034,-168.82,2110372,175160.88,1248,3349,0.56,57,11,0
1326,台化         ,20210222,-3,-0.25,32849,2736.32,-629,-52.4,2109774,175744.17,1585,2160,0.56,9,12,0
1326,台化         ,20210223,-14,-1.2,32835,2804.11,3177,271.32,2113379,180482.57,5927,3160,0.56,42,56,0
1326,台化         ,20210224,954,81.95,33789,2902.48,345,29.64,2113516,181551.02,3873,4509,0.58,954,0,0.01
1326,台化         ,20210225,59,5.23,33848,2998.93,7731,684.97,2121306,187947.71,8946,2010,0.58,147,88,0
1326,台化         ,20210226,986,84.8,34834,2995.72,-9736,-837.3,2110184,181475.82,5303,15955,0.59,988,2,0.01
1326,台化         ,20210302,-542,-46.77,34292,2959.4,-336,-29,2109926,182086.61,3192,2908,0.59,30,572,0.01
1326,台化         ,20210303,265,23.29,34557,3037.56,3594,315.91,2113454,185772.61,7624,5033,0.59,265,0,0
1326,台化         ,20210304,176,15.54,34733,3066.92,-3601,-317.97,2109297,186250.93,4472,8005,0.59,176,0,0
1326,台化         ,20210305,1582,138.27,36315,3173.93,-282,-24.65,2108899,184317.77,3070,4827,0.62,1582,0,0.01
1326,台化         ,20210308,803,70.66,37118,3266.38,2627,231.18,2111527,185814.38,4046,2876,0.63,956,153,0.01
1326,台化         ,20210309,143,12.66,37261,3297.6,2470,218.6,2113314,187028.29,4229,1673,0.64,143,0,0
1326,台化         ,20210310,21,1.86,37282,3310.64,321,28.5,2113563,187684.39,1957,1462,0.64,23,2,0
1326,台化         ,20210311,479,42.63,37761,3360.73,4274,380.39,2117474,188455.19,5239,1772,0.64,479,0,0
1326,台化         ,20210312,58,5.19,37819,3384.8,1160,103.82,2118571,189612.1,2161,782,0.65,58,0,0
1326,台化         ,20210315,33,2.91,37852,3334.76,-2402,-211.62,2116169,186434.49,1045,3436,0.65,33,0,0
1326,台化         ,20210316,-26,-2.29,37826,3324.91,-561,-49.31,2115671,185967.48,2613,2539,0.65,23,49,0
1326,台化         ,20210317,-49,-4.26,37777,3282.82,-3635,-315.88,2112450,183571.91,1891,5064,0.64,1,50,0
1326,台化         ,20210318,-630,-54.81,37147,3231.79,-1376,-119.71,2111666,183714.94,2859,3006,0.63,54,684,0.01
1326,台化         ,20210319,-2960,-249.24,34187,2878.55,-6694,-563.63,2105008,177241.67,6798,10496,0.58,94,3054,0.03
1326,台化         ,20210322,-49,-4.22,34138,2942.7,270,23.27,2105329,181479.36,2177,1763,0.58,16,65,0
1326,台化         ,20210323,-83,-7.15,34055,2932.14,-1090,-93.85,2104550,181201.76,1168,1864,0.58,9,92,0
1326,台化         ,20210324,-23,-1.96,34032,2896.12,-1378,-117.27,2103226,178984.53,1114,2382,0.58,48,71,0
1326,台化         ,20210325,-661,-56.78,33371,2866.57,337,28.95,2103461,180687.3,1744,553,0.57,46,707,0.01
1326,台化         ,20210326,-297,-25.9,33074,2884.05,1090,95.05,2104503,183512.66,2529,1190,0.56,3,300,0
1326,台化         ,20210329,0,0,33074,2907.2,149,13.1,2104696,185002.78,1841,1664,0.56,0,0,0
1326,台化         ,20210330,240,21.06,33314,2921.64,517,45.34,2105198,184625.86,2303,2028,0.57,240,0,0
1326,台化         ,20210331,-161,-14.08,33748,2956.32,-223,-19.53,2105551,184446.27,2021,2102,0.58,12,173,0
1326,台化         ,20210401,-7,-0.64,33741,2935.47,-1066,-92.74,2104486,183090.28,1224,2302,0.58,15,22,0
1326,台化         ,20210406,-136,-11.97,33605,2950.52,140,12.29,2104679,184790.82,1834,1486,0.57,0,136,0
1326,台化         ,20210407,-200,-17.5,33405,2922.94,-127,-11.11,2104690,184160.38,1539,1670,0.57,0,200,0
1326,台化         ,20210408,-309,-26.98,33096,2889.28,-1101,-96.12,2103589,183643.32,1747,2817,0.56,0,309,0
1326,台化         ,20210409,-13,-1.15,33083,2927.85,1046,92.57,2104635,186260.2,2620,1620,0.56,0,13,0
1326,台化         ,20210412,-71,-6.26,33012,2924.86,870,77.08,2105536,186550.49,4514,3482,0.56,11,82,0
1326,台化         ,20210413,-7,-0.6,33005,2917.64,-416,-36.77,2105098,186090.66,2512,2857,0.56,0,7,0
1326,台化         ,20210414,7,0.63,33012,2914.96,1059,93.51,2106226,185979.76,4124,3111,0.56,7,0,0
1326,台化         ,20210415,-2,-0.18,33010,2974.2,3018,271.92,2109244,190042.88,4516,1797,0.56,0,2,0
1326,台化         ,20210416,-4,-0.37,33006,3036.55,2614,240.49,2111858,194290.94,3906,1640,0.56,0,4,0
1326,台化         ,20210419,1317,125.34,34323,3267.55,5316,506.08,2117177,201555.25,6043,2634,0.59,1447,130,0.01
1326,台化         ,20210420,-24,-2.26,34299,3251.55,-334,-31.66,2115837,200581.35,3551,3149,0.59,3,27,0
1326,台化         ,20210421,-91,-8.43,34208,3181.34,-790,-73.47,2114261,196626.27,3005,3661,0.58,10,101,0
1326,台化         ,20210422,12,1.16,34220,3189.3,2849,265.53,2117407,197342.33,5288,2387,0.58,12,0,0
1326,台化         ,20210423,-957,-88.84,33263,3086.81,782,72.57,2118304,196578.61,3211,1375,0.57,3,960,0.01
1326,台化         ,20210426,-276,-25.67,32987,3067.79,219,20.37,2118265,196998.65,1813,1255,0.56,0,276,0
1326,台化         ,20210427,-128,-11.9,32859,3055.89,2807,261.05,2121138,197265.83,4360,1276,0.56,0,128,0
1326,台化         ,20210428,-2,-0.17,32857,3019.56,94,8.64,2121118,194930.74,2230,2151,0.56,3,5,0
1326,台化         ,20210429,-456,-41.41,32401,2945.25,1154,104.9,2121876,192878.53,3008,1300,0.55,15,471,0
1326,台化         ,20210503,-199,-18.01,32202,2907.84,1009,91.11,2122891,191697.06,3176,1964,0.55,21,220,0
1326,台化         ,20210504,24,2.14,32226,2887.45,1417,126.96,2124402,190346.42,5982,4754,0.55,28,4,0
1326,台化         ,20210505,-140,-12.73,32086,2923.03,1342,122.26,2125663,193647.9,3123,1929,0.55,14,154,0
1326,台化         ,20210506,-166,-15.64,31920,3000.48,1354,127.28,2127018,199939.69,3818,3067,0.54,33,199,0
1326,台化         ,20210507,-454,-41.18,31466,2853.97,-2267,-205.62,2124792,192718.63,2993,4694,0.54,7,461,0
1326,台化         ,20210510,-2354,-215.64,29112,2666.66,241,22.08,2124642,194617.21,3867,1135,0.5,15,2369,0.02
1326,台化         ,20210511,103,9.2,29215,2603.06,-380,-33.86,2124050,189252.86,3485,3035,0.5,103,0,0
1326,台化         ,20210512,94,7.86,29309,2450.23,-613,-51.25,2124061,177571.5,6647,6959,0.5,94,0,0
1326,台化         ,20210513,33,2.69,29342,2391.37,-3901,-317.93,2120360,172809.34,3752,7694,0.5,33,0,0
1326,台化         ,20210514,80,6.63,29422,2439.08,-770,-63.83,2118618,175633.43,2984,3942,0.5,80,0,0
1326,台化         ,20210517,15,1.21,29437,2381.45,-1792,-144.97,2115980,171182.78,2737,4516,0.5,15,0,0
1326,台化         ,20210518,17,1.42,29454,2462.35,-75,-6.27,2116434,176933.88,2006,2679,0.5,17,0,0
1326,台化         ,20210519,-55,-4.6,29399,2460.7,-1287,-107.72,2115178,177040.4,1633,2918,0.5,0,55,0
1326,台化         ,20210520,-196,-16.5,29203,2458.89,-1300,-109.46,2132062,179519.62,3075,4058,0.5,0,196,0
1326,台化         ,20210521,120,10.1,29323,2469,-509,-42.86,2131521,179474.07,2132,2614,0.5,120,0,0
1326,台化         ,20210524,168,14.06,29491,2468.4,-536,-44.86,2130980,178363.03,1292,2002,0.5,168,0,0
1326,台化         ,20210525,-82,-7,29409,2511.53,2341,199.92,2133240,182178.7,4455,2030,0.5,3,85,0
1326,台化         ,20210526,3,0.25,29412,2485.31,-862,-72.84,2132445,180191.6,1629,2582,0.5,3,0,0
1326,台化         ,20210527,-6,-0.49,29406,2490.69,-1874,-158.73,2130221,180429.72,7797,9337,0.5,9,15,0
1326,台化         ,20210528,1,0.09,29407,2511.36,-673,-57.47,2130073,181908.23,3172,3844,0.5,1,0,0
1326,台化         ,20210531,-76,-6.48,29331,2510.73,257,22,2131281,182437.65,2017,1583,0.5,0,76,0
1326,台化         ,20210601,-29,-2.53,29302,2555.13,1693,147.63,2132494,185953.48,3069,1426,0.5,0,29,0
1326,台化         ,20210602,-1,-0.05,29301,2604.86,1318,117.17,2133813,189695.98,3745,2659,0.5,0,1,0
1326,台化         ,20210603,0,0,29301,2593.14,601,53.19,2134413,188895.55,1841,1251,0.5,0,0,0
1326,台化         ,20210604,-1,-0.05,29300,2569.61,624,54.72,2135037,187242.74,1391,766,0.5,0,1,0
1326,台化         ,20210607,3,0.29,29303,2566.94,-9,-0.79,2135027,187028.37,1368,1492,0.5,4,1,0
1326,台化         ,20210608,4,0.35,29307,2532.12,-15,-1.3,2134949,184459.59,1400,1367,0.5,4,0,0
1326,台化         ,20210609,-168,-14.38,29139,2494.3,-947,-81.06,2133987,182669.29,1565,1652,0.5,0,168,0
1326,台化         ,20210610,-6,-0.52,29133,2522.92,1084,93.87,2135010,184891.87,2527,1466,0.5,0,6,0
1326,台化         ,20210611,-27,-2.32,29106,2497.29,-118,-10.12,2134699,183157.17,1112,1188,0.5,19,46,0
1326,台化         ,20210615,-5,-0.43,29101,2479.41,-1151,-98.07,2133445,181769.51,1000,2168,0.5,0,5,0
1326,台化         ,20210616,-78,-6.73,29023,2498.88,748,64.4,2133856,183725,1709,1630,0.5,0,78,0
1326,台化         ,20210617,-125,-10.66,28898,2465,-749,-63.89,2132783,181926.39,1217,1835,0.49,10,135,0
1326,台化         ,20210618,-2105,-175.35,26793,2231.86,-5050,-420.67,2127733,177240.16,4815,7667,0.46,18,2123,0.02
1326,台化         ,20210621,62,5.1,26855,2223.59,-1549,-128.26,2126184,176048.04,1436,2854,0.46,62,0,0
1326,台化         ,20210622,-76,-6.33,26779,2230.69,-437,-36.4,2125747,177074.73,1188,1612,0.46,0,76,0
1326,台化         ,20210623,-52,-4.39,26727,2258.43,1563,132.07,2127395,179764.88,2846,2705,0.46,18,70,0
1326,台化         ,20210624,-143,-12.07,26584,2243.69,31,2.62,2127425,179554.67,1217,1301,0.45,18,161,0
1326,台化         ,20210625,-438,-37.05,26146,2211.95,645,54.57,2128272,180051.81,2498,1800,0.45,10,448,0
1326,台化         ,20210628,0,0,26146,2222.41,98,8.33,2128465,180919.53,1212,1155,0.45,0,0,0
1326,台化         ,20210629,-127,-10.74,26019,2201.21,-895,-75.72,2129270,180136.24,2087,2854,0.44,3,130,0
1326,台化         ,20210630,-8,-0.68,31820,2695.15,1,0.08,2132711,180640.62,1697,1752,0.54,0,8,0
1326,台化         ,20210701,1,0.09,31821,2704.79,-1192,-101.32,2131519,181179.12,1426,2690,0.54,1,0,0
1326,台化         ,20210702,-2,-0.17,31819,2707.8,-1368,-116.42,2130152,181275.94,2871,4262,0.54,0,2,0
1326,台化         ,20210705,-95,-8.2,31724,2744.13,-401,-34.69,2129751,184223.46,2278,2733,0.54,3,98,0
1326,台化         ,20210706,0,0,31724,2753.64,2211,191.91,2131650,185027.22,3522,1306,0.54,0,0,0
1326,台化         ,20210707,-4,-0.34,31720,2721.58,-858,-73.62,2130702,182814.23,1446,2275,0.54,0,4,0
1326,台化         ,20210708,0,0,31720,2715.23,652,55.81,2129576,182291.71,2098,1453,0.54,1,1,0
1326,台化         ,20210709,16,1.36,31736,2700.73,-2339,-199.05,2122965,180664.32,2465,4794,0.54,16,0,0
1326,台化         ,20210712,-63,-5.36,31673,2692.21,486,41.31,2125488,180666.48,2149,1615,0.54,8,71,0
1326,台化         ,20210713,-10,-0.83,31663,2704.02,907,77.46,2126523,181605.06,2115,1373,0.54,0,10,0
1326,台化         ,20210714,-29,-2.49,31634,2717.36,707,60.73,2127230,182729.06,2728,2133,0.54,1,30,0
1326,台化         ,20210715,-92,-7.87,31542,2690.53,-1859,-158.57,2125482,181303.61,1295,2992,0.54,20,112,0
1326,台化         ,20210716,-60,-5.14,31482,2698.01,278,23.82,2125760,182177.63,1188,839,0.54,0,60,0
1326,台化         ,20210719,0,0,31482,2675.97,-1653,-140.51,2124108,180549.18,1772,3401,0.54,0,0,0
1326,台化         ,20210720,-60,-5,31422,2617.45,-2791,-232.49,2121433,176715.37,745,3417,0.54,7,67,0
1326,台化         ,20210721,14,1.16,31436,2606.04,-2091,-173.34,2119362,175695.11,839,3615,0.54,21,7,0
1326,台化         ,20210722,-8,-0.71,31428,2646.24,726,61.13,2119813,178488.25,2792,2158,0.54,12,20,0
1326,台化         ,20210723,4,0.34,31432,2646.57,692,58.27,2120484,178544.75,1656,993,0.54,4,0,0
1326,台化         ,20210726,-5,-0.42,31427,2614.73,-2625,-218.4,2117812,176201.96,793,3422,0.54,1,6,0
1326,台化         ,20210727,37,2.98,31464,2536,349,28.13,2116503,170590.14,2910,2606,0.54,37,0,0
1326,台化         ,20210728,85,6.92,31549,2561.78,-540,-43.85,2115467,171775.92,3178,4407,0.54,104,19,0
1326,台化         ,20210729,5,0.39,31554,2584.27,-15,-1.23,2115453,173255.6,1928,1947,0.54,10,5,0
1326,台化         ,20210730,-3,-0.22,31551,2593.49,-208,-17.1,2113414,173722.63,2195,2450,0.54,1,4,0
1326,台化         ,20210802,-1,-0.11,31550,2628.12,1939,161.52,2115354,176208.99,3005,1254,0.54,0,1,0
1326,台化         ,20210803,-9,-0.71,31541,2621.06,-808,-67.14,2114545,175718.69,1388,2144,0.54,0,9,0
1326,台化         ,20210804,7,0.56,31548,2621.64,587,48.78,2115084,175763.48,2310,1748,0.54,13,6,0
1326,台化         ,20210805,-11,-0.96,31537,2620.72,363,30.17,2115448,175793.73,1845,1468,0.54,0,11,0
1326,台化         ,20210806,0,0,31537,2639.65,128,10.71,2115577,177073.79,2627,2358,0.54,0,0,0
1326,台化         ,20210809,1,0.08,31538,2617.65,-537,-44.57,2115083,175551.89,2824,3300,0.54,1,0,0
1326,台化         ,20210810,4,0.33,31542,2586.44,-753,-61.75,2114356,173377.19,775,1506,0.54,5,1,0
1326,台化         ,20210811,32,2.65,31574,2611.17,839,69.39,2115195,174926.63,2228,1423,0.54,32,0,0
1326,台化         ,20210812,17,1.41,31591,2612.58,210,17.37,2115357,174940.02,880,735,0.54,17,0,0
1326,台化         ,20210813,14,1.14,31605,2582.13,-610,-49.84,2114767,172776.46,1074,1677,0.54,14,0,0
1326,台化         ,20210816,28,2.28,31633,2571.76,163,13.25,2114945,171945.03,1728,1578,0.54,28,0,0
1326,台化         ,20210817,10,0.81,31643,2578.9,71,5.79,2114981,172370.95,2476,2413,0.54,10,0,0
1326,台化         ,20210818,51,4.17,31694,2589.4,-357,-29.17,2114567,172760.12,1403,1880,0.54,51,0,0
1326,台化         ,20210819,38,3.05,31732,2544.91,-2798,-224.4,2111814,169367.48,2155,4873,0.54,38,0,0
1326,台化         ,20210820,62,4.92,31794,2514.91,-3191,-252.41,2108351,166770.56,1043,4319,0.54,62,0,0
1326,台化         ,20210823,33,2.64,31827,2549.34,-149,-11.93,2108494,168890.37,1280,1422,0.54,33,0,0
1326,台化         ,20210824,17,1.38,31844,2588.92,221,17.97,2107924,171374.22,2455,2280,0.54,17,0,0
1326,台化         ,20210825,12,1.01,31856,2599.45,-486,-39.66,2107361,171960.66,1652,2227,0.54,12,0,0
1326,台化         ,20210826,1,0.08,31857,2570.86,-1244,-100.39,2106151,169966.39,1491,2702,0.54,2,1,0
1326,台化         ,20210827,0,0,31857,2628.2,2420,199.65,2108520,173952.9,2940,842,0.54,0,0,0
1326,台化         ,20210830,12,1.01,31869,2673.81,2034,170.65,2110586,177078.17,2805,771,0.54,12,0,0
1326,台化         ,20210831,0,0,31869,2680.18,1366,114.88,2111768,177599.69,5049,3673,0.54,0,0,0
1326,台化         ,20210901,-5,-0.42,31864,2647.9,-904,-75.12,2110939,175419.03,1475,2376,0.54,0,5,0
1326,台化         ,20210902,-10,-0.83,31854,2608.84,-573,-46.93,2110799,172874.44,965,1544,0.54,1,11,0
1326,台化         ,20210903,-2,-0.2,31852,2643.72,1987,164.92,2112786,175361.24,2491,644,0.54,8,10,0
1326,台化         ,20210906,-17,-1.43,31835,2616.84,380,31.24,2113198,173704.88,899,543,0.54,1,18,0
1326,台化         ,20210907,-4,-0.37,31831,2632.42,724,59.87,2113923,174821.43,1329,586,0.54,5,9,0
1326,台化         ,20210908,-35,-2.88,31796,2613.63,115,9.45,2114277,173793.57,1991,1414,0.54,39,74,0
1326,台化         ,20210909,-5,-0.41,31791,2590.97,-700,-57.05,2113588,172257.42,1381,2064,0.54,0,5,0
1326,台化         ,20210910,-6,-0.49,31785,2609.55,501,41.13,2114075,173565.56,1492,1000,0.54,0,6,0
1326,台化         ,20210913,0,0,31785,2631.8,537,44.46,2114617,175090.29,1382,839,0.54,0,0,0
1326,台化         ,20210914,3,0.25,31788,2644.76,1216,101.17,2115901,176042.96,1962,762,0.54,3,0,0
1326,台化         ,20210915,53,4.41,31841,2652.36,466,38.82,2116838,176332.61,3137,2310,0.54,55,2,0
1326,台化         ,20210916,3,0.25,31844,2658.97,755,63.04,2119150,176949.03,1841,1043,0.54,3,0,0
1326,台化         ,20210917,-362,-29.82,31482,2590.97,-688,-56.62,2118460,174349.26,5947,6289,0.54,0,362,0
1326,台化         ,20210922,5,0.4,31487,2534.7,-4480,-360.64,2114396,170208.88,1490,5351,0.54,5,0,0
1326,台化         ,20210923,4,0.33,31491,2560.22,611,49.67,2114915,171942.59,1649,1023,0.54,4,0,0
1326,台化         ,20210924,-66,-5.43,31425,2583.14,1017,83.6,2116100,173943.42,1814,740,0.54,0,66,0
1326,台化         ,20210927,0,0,31425,2630.27,2515,210.51,2118690,177334.35,3175,765,0.54,0,0,0
1326,台化         ,20210928,0,0,31425,2652.27,775,65.41,2119031,178846.22,2128,1388,0.54,0,0,0
1326,台化         ,20210929,213,17.79,31638,2641.77,-851,-71.06,2118773,176917.55,2840,3230,0.54,228,15,0
1326,台化         ,20210930,136,11.41,29877,2506.68,888,74.5,2117892,177691.14,3374,2622,0.51,138,2,0
1326,台化         ,20211001,12,0.98,29889,2450.9,-3320,-272.24,2114569,173394.66,1885,5224,0.51,42,30,0
1326,台化         ,20211004,73,6.02,29962,2471.86,1144,94.38,2115276,174510.27,3083,2098,0.51,73,0,0
1326,台化         ,20211005,102,8.38,30064,2471.26,-1986,-163.25,2113173,173702.82,2207,4365,0.51,102,0,0
1326,台化         ,20211006,53,4.43,30117,2514.77,1443,120.49,2114283,176542.63,5456,4051,0.51,53,0,0
1326,台化         ,20211007,47,3.96,30164,2539.81,2031,171.01,2116294,178191.95,4115,2882,0.51,50,3,0
1326,台化         ,20211008,18,1.52,30182,2547.36,148,12.49,2116515,178633.87,1632,1503,0.51,18,0,0
1326,台化         ,20211012,46,3.82,30228,2511.95,-5089,-422.9,2112554,175553.24,4095,8573,0.52,46,0,0
1326,台化         ,20211013,63,5.19,30291,2495.98,-775,-63.86,2111717,174005.48,2480,3406,0.52,63,0,0
1326,台化         ,20211014,0,0,30291,2486.89,-604,-49.59,2111027,173315.32,1537,2227,0.52,0,0,0
1326,台化         ,20211015,0,0,30291,2511.12,417,34.57,2111248,175022.46,2409,2064,0.52,0,0,0
1326,台化         ,20211018,-353,-29.07,29938,2463.9,-1012,-83.29,2110245,173673.16,1653,2337,0.51,5,358,0
1326,台化         ,20211019,-990,-81.18,28948,2373.74,-1559,-127.84,2108846,172925.37,2067,2859,0.49,0,990,0.01
1326,台化         ,20211020,-1517,-124.7,27431,2254.83,-1794,-147.47,2107052,173199.67,1700,1945,0.47,0,1517,0.01
1326,台化         ,20211021,-4,-0.33,27427,2254.5,-90,-7.4,2106766,173176.17,10943,10971,0.47,0,4,0
1326,台化         ,20211022,-1,-0.08,27426,2226.99,-2424,-196.83,2104415,170878.5,1290,3718,0.47,0,1,0
1326,台化         ,20211025,21,1.7,27447,2220.46,-1627,-131.62,2103291,170156.24,1792,3436,0.47,21,0,0
1326,台化         ,20211026,10,0.81,27457,2229.51,-413,-33.54,2102943,170758.97,4667,4881,0.47,10,0,0
1326,台化         ,20211027,0,0,27457,2226.76,-2097,-170.07,2100889,170382.1,905,3038,0.47,0,0,0
1326,台化         ,20211028,0,0,27457,2218.53,-1945,-157.16,2098658,169571.57,1117,2762,0.47,0,0,0
1326,台化         ,20211029,-149,-11.99,27308,2198.29,-2754,-221.7,2096154,168740.4,2323,4790,0.47,8,157,0
1326,台化         ,20211101,26,2.1,27334,2205.85,-988,-79.73,2095412,169099.75,1687,2455,0.47,26,0,0
1326,台化         ,20211102,22,1.77,27356,2196.69,-2186,-175.54,2093283,168090.62,1614,3764,0.47,22,0,0
1326,台化         ,20211103,10,0.8,27366,2200.23,-2509,-201.72,2091387,168147.51,896,2760,0.47,11,1,0
1326,台化         ,20211104,14,1.13,27380,2206.83,-1210,-97.53,2090135,168464.88,1445,2723,0.47,15,1,0
1326,台化         ,20211105,34,2.74,27414,2206.83,-1407,-113.26,2088848,168152.26,840,2287,0.47,34,0,0
1326,台化         ,20211108,101,8.15,27515,2220.46,-916,-73.92,2088223,168519.6,1453,2479,0.47,101,0,0
1326,台化         ,20211109,76,6.12,27591,2223.83,-2089,-168.37,2086545,168175.53,1789,3987,0.47,81,5,0
1326,台化         ,20211110,109,8.77,27700,2229.85,-1449,-116.64,2085428,167876.95,1118,2775,0.47,109,0,0
1326,台化         ,20211111,227,18.25,27927,2245.33,-1410,-113.36,2083247,167493.06,1275,2950,0.48,227,0,0
1326,台化         ,20211112,177,14.43,28104,2290.48,1063,86.63,2083919,169839.4,2010,1228,0.48,177,0,0
1326,台化         ,20211115,3,0.24,28107,2285.1,52,4.23,2084146,169441.07,1170,1138,0.48,108,105,0
1326,台化         ,20211116,159,12.89,28266,2292.37,-112,-9.08,2083853,169000.48,1571,1927,0.48,159,0,0
1326,台化         ,20211117,296,23.98,28562,2313.52,-1712,-138.67,2081653,168613.89,964,3530,0.49,296,0,0
1326,台化         ,20211118,64,5.19,28626,2321.57,-85,-6.89,2081656,168822.3,1798,2012,0.49,109,45,0
1326,台化         ,20211119,60,4.85,28686,2317.83,-1224,-98.9,2080731,168123.06,624,1896,0.49,62,2,0
1326,台化         ,20211122,15,1.2,28701,2301.82,-1738,-139.39,2079049,166739.73,1215,2997,0.49,15,0,0
1326,台化         ,20211123,0,0,28701,2298.95,-892,-71.45,2078444,166483.36,999,1931,0.49,0,0,0
